ab-rogar	esfazer
aba	beirada
ababadar	arrepanhar
ababadar-se	repanhar-se
ababelado	desarrumado
ababelar	unir
ababelar-se	unir-se
ababocado	mazanza
abacelar	embacelar
abacto	abigeato
abadiva	badejo
abafadi�o	pesado
abafado	enfrenado
abafador	abafante
abafar	calar
abafar-se	acobertar-se
abafa��o	oculta��o
abainhar	embainhar
abaixamento	aca�apamento
abaixante	aviltante
abaixar	acocorar
abaixar-se	aplainar-se
abajoujado	hebetizado
abajur	lucivelo
abalada	disparada
abalado	inseguro
abaladura	abalamento
abalan�ar	estimular
abalar	tumultuar
abalar-se	impressionar-se
abalienado	delirante
abalizado	consumado
abalizar	assinalar
abaloado	pando
abalofado	arrebicado
abalofar	fofar
abalroada	colis�o
abalroar	contender
abalroar-se	tocar-se
abalsar	embal�ar
abalsar-se	meter-se
abanamento	agita��o
abananado	apombocado
abanar	balou�ar
abandalhado	amariolado
abandalhamento	enxovalhamento
abandalhar-se	aviltar-se
abandar	apartar
abandonamento	desprendimento
abandonar	negar
abandonar-se	descurar-se
abandono	arrenega��o
abanicar-se	refrescar-se
abaratar	abaratear
abaratear	rebaixar
abarbar	sobrecarregar
abarbar-se	aplainar-se
abarbarado	corajoso
abarcamento	abrang�ncia
abarcante	a�ambarcador
abarcar	atinar
abarracado	acampado
abarracar	acampar
abarrancar	represar
abarregar-se	juntar-se
abarreirar	ingurgitar
abarreirar-se	resguardar-se
abarrotado	superlotado
abarrotamento	atafulhamento
abarrotar	preencher
abarrotar-se	cumular-se
abar�	padre
abas	adjac�ncias
abasbacar	trepidar
abastadear	desdizer
abastado	ourudo
abastan�a	abund�ncia
abastar-se	aperceber-se
abastardamento	bastardia
abastecer	fornecer
abastecer-se	a�almar-se
abastecido	aparelhado
abastoso	adinheirado
abatedoiro	abatedouro
abater	desapear
abater-se	inferiorizar-se
abatido	rebaixado
abatimento	quebrantamento
abatocado	atapulhado
abatocar	tapar
abatumado	abetumado
abaulado	acurvado
aba�anado	trigueiro
aba�anar	desdourar
abduzir	arrancar
abduzir-se	afastar-se
abeberar	desalterar
abeg�o	camp�nio
abeirante	rente
abeirar-se	unir-se
abelhudar	sondar
abelhudice	intromiss�o
abelhudo	metido
abemolar	ceder
abemolar-se	afetar-se
aben�oadeiro	benzedor
aben�oar	bendizer
aberrativo	an�malo
aberta	abert�o
abertal	aberti�o
aberto	aprofundado
abertura	vau
abespinhado	sanhoso
abespinhar	encolerizar
abespinhar-se	esturrar-se
abespinh�vel	anojadi�o
abestalhado	atroado
abetumar	argamassar
abicar	agu�ar
abichado	bichoso
abichar	pilhar
abilolado	desabotinado
abio	abiu
abiscoitar	arranjar
abismado	estupefato
abismamento	assombro
abismar	desgalgar
abismo	b�ratro
abi�do	adiantado
abjudicador	abjurgante
abjugar	desaconchegar
abjura��o	abrenuncia��o
ablegar	mandar
ablegar-se	desligar-se
abluente	detergente
abluir	escorificar
abluir-se	alimpar-se
ablu��o	limpeza
abnegar	renunciar
abnoitar	dormir
abnuir	recusar
abn�xio	inofensivo
abobadado	recurvado
abobadar	arquear
abobado	abobarrado
abobalhado	apatetado
abobalhar	aparvalhar
abobalhar-se	apatetar-se
abobar	idiotar
abobarrado	tarouco
abocamento	encontro
abochornador	bochornal
abodegar	enquizilar
abodegar-se	sujar-se
abodega��o	aborrecimento
aboiado	aboio
aboiar	bubuiar
abolar	bolear
aboleimar	apalmar
aboleimar-se	achatar-se
aboletar	agasalhar
abolir	esfazer
aboli��o	revoga��o
abolorentar	mofar
abolsar	crescer
abolsar-se	estufar-se
abol�ar	rejeitar
abominar-se	aborrecer-se
abominoso	aborrecido
abonado	ourudo
abonan�ar	apacificar
abonan�ar-se	sossegar-se
abonar	oferecer
abonativo	abon�vel
abona��o	louvor
abonecar-se	ajaezar-se
aboquejar	caluniar
aborcar	esvazar
abordada	abordagem
abordar	versar
aboriginal	crioulo
aborrecer	amaldi�oar
aborrecer-se	enjoar-se
aborrecido	ma�ador
aborrecimento	chatea��o
aborrido	ma�ante
abortado	apagado
abortar	malparir
abortivo	baldado
aborto	anomalia
abort�fero	abortivo
abotoar	surgir
abra	anco
abracadabrante	m�gico
abrac�vel	abrang�vel
abrancar	caiar
abranca�ado	entrebranco
abrandado	dulcificado
abrandamento	acalma��o
abrandar	desempedernecer
abrandar-se	amortecer-se
abranger	possuir
abranger-se	incluir-se
abrang�ncia	encerramento
abrasamento	adust�o
abrasar	dissipar
abrasar-se	eletrizar-se
abrasear	enrubescer
abras�o	esfola
abra�amento	amplexo
abra�ar	juntar
abra�o	liga��o
abre-ilhoses	saca-bocado
abre-ilh�s	saca-bocado
abrevar	beberar
abreviadamente	laconicamente
abreviado	encondensado
abreviar	precipitar
abreviativo	simplificador
abrevia��o	encurtamento
abricoque	albricoque
abrigado	amparado
abrigadouro	prote��o
abrigar	garantir
abrigar-se	cobrir-se
abril	juvenilidade
abrilhantado	adere�ado
abrilhantar	avivar
abrir	elucidar
abrir-se	dilacerar-se
abrolho	percal�o
abronzeado	bronzedo
abrupto	ladeirento
abrutado	abrutalhado
abrutalhado	rude
abrutalhar	bestializar
abrutamento	rudeza
abscesso	intumesc�ncia
abscindido	estropiado
absconder	encafuar
absconder-se	ocultar-se
absconso	esconso
absc�ndito	oculto
absente�smo	abstencionismo
absidado	alcatruzado
absimilhante	dissemelhante
absolutamente	despoticamente
absoluto	tirano
absolver	escusar
absolver-se	isentar-se
absolvi��o	indulg�ncia
absonar	desatremar
absorbente	aspirante
absorciso	absortivo
absorvedoiro	tragadouro
absorver	gastar
absorver-se	empregar-se
absor��o	�xtase
abstemia	frugalidade
absten��o	neutralidade
abster-se	coibir-se
absterger-se	depurar-se
absterso	purificado
abstin�ncia	jejum
abstraente	abstraidor
abstrair	afastar
abstrair-se	separar-se
abstrato	alheio
abstra��o	alheamento
abstra�do	abstrato
abstruso	esconso
abst�mico	abst�mio
absurdo	incoerente
abs�ntio	absinto
abugalhar	esgazear
abugalhar-se	arregalar-se
abundante	farto
abundar	sobreabundar
abund�ncia	provimento
aburacar	broquear
abusado	intruso
abusar	exorbitar
abuso	contraven��o
abuzinado	afunilado
ab�bora	jerimum
aca	raposinho
acabado	encerrado
acabamento	destrui��o
acabar	executar
acabar-se	diminuir-se
acabrunhado	aniquilado
acabrunhar	ansiar
acabrunhar-se	atormentar-se
acachapar	subterrar
acachar	amoutar
acafelado	encoberto
acafelamento	reboco
acafelar	mentir
acairelar	cairelar
acai�arado	alarve
acalantar	mimar
acalentamento	carinho
acalentar	bafejar
acalento	al�vio
acalmado	aplacado
acalmamento	mitiga��o
acalmar	retundir
acalmar-se	placar
acalma��o	acalmamento
acalorado	esfogueado
acalorar-se	entusiasmar-se
acamado	assentado
acambetar	coxear
acampamento	rancho
acampanar	espevitar
acanalar	ranhurar
acanalhado	amolecado
acanalhar-se	desonrar-se
acanaveadura	crucia��o
acanavear	dilacerar
acanavear-se	emagrecer-se
acanelar	estriar
acanhado	covarde
acanhamento	aperto
acanhar	avergonhar
acanhar-se	embara�ar-se
acantoar	isolar
acantol�gico	mordaz
acapachado	humilhado
acapelado	enfurecido
acapelar	fundir
acarar	afrontar
acarar-se	olhar-se
acareador	acareante
acarear	carear
acariciado	ameigado
acariciador	amimador
acariciante	fagueiro
acariciar	mimosear
acariciativo	amimador
acarinhamento	quindim
acarinhar	mimar
acarminar	envermelhecer
acarpetar	entapizar
acarrar	resfolegar
acarrear	suscitar
acarretar	produzir
acarreto	plagiato
acasalar-se	concubinar-se
acasmurrado	porfiado
acaso	quinh�o
acastelado	coacervado
acastelar-se	acumular-se
acastoado	encastoado
acatamento	obedi�ncia
acatar	aceitar
acatingado	catingoso
acatitado	aperaltado
acautelado	velhaco
acautelar-se	resguardar-se
acavalar	superpor
aca�apar	encafuar
aca�apar-se	acovar-se
aceder	acrescentar
aceirar	agu�ar
aceitar	subscrever
aceita��o	aprova��o
aceit�vel	recept�vel
acelerar	apressar
acenar	menear
acender	espica�ar
acender-se	vulcanizar-se
acendrado	apurado
acendrar	defecar
acend�vel	inflam�vel
acentuado	saliente
acentuar	pronunciar
acepilhado	polido
acep��o	significado
acerar	azerar
acerbidade	austeridade
acerbo	amaroso
acercar-se	aconchegar-se
acertamento	transa��o
acervo	amontoado
aceso	arremessado
acesso	comunica��o
acess�o	acrescente
acess�vel	comunicativo
acess�rio	detalhe
acetificar-se	vinagrar-se
achacado	corrompido
achado	inventado
achamboado	mal-enjorcado
achambonado	achavascado
achanar	alhanar
achaque	mol�stia
achar	desentesourar
achar-se	encontrar-se
achatadura	amolgadura
achatar	esmagar
achatar-se	agachar-se
achega	ajudadouro
achegar-se	chegar-se
achincalhamento	esc�rnio
achincalha��o	achincalhe
achincalhe	ridiculiza��o
achinfrinado	turbulento
acidade	acidez
acidentar	lesionar
acidente	contratempo
acident�rio	brusco
acid�vel	acidific�vel
acima	ascensionalmente
acinte	inj�ria
acintoso	maldadoso
acion�rio	acionista
acipreste	cipreste
acirrado	exacerbado
acirramento	concita��o
acirrante	exasperante
acirrar	pruir
acirrar-se	exasperar-se
aclamado	aplaudido
aclama��o	prova
aclarar	expurgar
aclarar-se	alumbrar-se
aclarecer	escurentar
aclimado	avezado
aclimar-se	habituar-se
aclimatado	treito
aclimatar-se	aclimatizar-se
aclimata��o	ajustamento
aclimat�vel	aclim�vel
aclima��o	aclimata��o
aclivoso	enladeirado
acme	c�mulo
acobardado	atemorado
acobardar	atemorizar
acobardar-se	atemorizar-se
acobertar	roupar
acobertar-se	enroupar-se
acochar	inquerir
acoelhado	assustado
acogulado	atulhado
acoimado	castigado
acoimador	repreensor
acoimar	encoimar
acoitar	acolher
acoitar-se	entroixar-se
acolchetar	colchetar
acolher	agasalhar
acolhimento	guarida
acometer	apossear-se
acometimento	saltada
acomodado	digno
acomodar	arrumar
acomodar-se	adequar-se
acomplei�oado	acomplexionado
acomunar-se	mancomunar-se
aconchavar	ajustar
aconchavar-se	aparceirar-se
aconchegado	aproximado
aconchegar	vizinhar
aconchegar-se	encolher-se
acondicionar	justar
acondutar	picuar
aconselhado	recomendado
aconselhamento	persuas�o
acontecimento	evento
acordamento	excita��o
acordar	concitar
acordo	conformidade
acoro�oar	esperan�ar
acorrer	lembrar
acor�oar	aquecer
acossamento	encal�o
acossar	confranger
acostado	parasita
acostar	coser
acostumado	aquilotado
acostumar	traquejar
acostumar-se	costumar-se
acotovelar	esporar
acoucear	agredir
acoutar	gasalhar
acoutar-se	aninhar-se
acovar	cravar
acovar-se	amoutar-se
acovardado	atemorado
acovardar	atemorizar
acovardar-se	estremecer-se
acravar-se	espetar-se
acre	agro
acre-doce	agridoce
acreditado	afian�ado
acreditar	crer
acredit�vel	cr�vel
acrescentado	anexado
acrescentar	temperar
acrescente	adiciona��o
acrescer-se	adicionar-se
acridez	requeime
acrim�nia	agro
acrisolado	cendrado
acrisolar	madurar
acrisolar-se	perfei�oar-se
acroase	disserta��o
acr�scimo	adicionamento
acr�bata	volatim
acua��o	acuamento
acudir	afluir
acuidade	fineza
acume	m�ximo
acumetria	acuometria
acuminar	amolar
acumpliciar	cumpliciar
acumular	coacervar
acumula��o	aglomera��o
acupunctura	acupuntura
acurado	aprimorado
acurar-se	refinar-se
acurralar	encantoar
acurrar	enrinconar
acurtar	compactar
acurvado	alombado
acurvamento	derreamento
acurvar	dobrar
ac�rrimo	teimoso
ac�tico	acre
ac�modo	favor�vel
ac�ntio	seta
ac�men	fast�gio
ac�mulo	mont�o
adamado	alfeninado
adaptado	habituado
adaptar	preparar
adaptar-se	moldar-se
adapta��o	conforma��o
adargar-se	velar-se
adejar	jogar
adelgadar	renegar
adelgar	empalecer
adelgar-se	afilar-se
adelga�amento	afunilamento
adelga�ar	engoiar-se
adensar	condensar
adensar-se	inspissar-se
adentrar	embocar
adepto	pros�lito
adequadamente	propriamente
adequar	harmonizar
adequar-se	arranjar-se
adequa��o	correspond�ncia
adere�ado	aparamentado
adere�amento	decora��o
adere�ar	emoldar
adere�ar-se	ataviar-se
adere�o	requifife
adergar	falar
aderir	gostar
adestrado	industriado
adestrar	disciplinar
adiado	retardado
adiamento	transfer�ncia
adiantado	antecipado
adiantar	antecipar
adiantar-se	avan�ar
adiar	espacejar
adicionado	aposto
adicionamento	aumento
adicionar	enxertar
adido	amparado
adinamizar	desvigorizar
adinheirar	adornar
adiposidade	corpul�ncia
adiposo	balofo
aditamento	adje��o
adivinhador	�uspice
adivinhar	depreender
adivinha��o	predefini��o
adi�vel	protel�vel
adi��o	suplemento
adjacente	arredor
adjac�ncia	arrebalde
adjeto	conjunto
adjudicar	concatenar
adjugar	descativar
adjunto	auxiliador
adjun��o	associa��o
adjurar	invocar
adjut�rio	ajudadouro
administrado	encabe�ado
administrador	despenseiro
administrar	governar
administra��o	dire��o
admin�culo	ajudadoiro
admirabilidade	genialidade
admirado	banzado
admirar-se	mirar-se
admira��o	estranheza
admir�vel	excelente
admiss�o	aprova��o
admitir	permitir
admoestador	admonitor
admoestar	escovar
admoni��o	escarmento
adoba	adobe
adocicado	mel�fluo
adocicar	dulcificar
adocicar-se	amulherar-se
adoidar	endoidecer
adolescer	gradar
adolo	rapap�
adomar	temperar
adomesticar	domesticar
adonismo	garridice
adorador	f�
adormecer	atenuar
adormecido	repousado
adormentar	amortificar
adornado	ataviado
adornar	formosentar
adornar-se	paramentar-se
adorno	guarnecimento
adotar	presentar
adoudado	destrambelhado
adoudar	variar
ado�ado	dulcificado
ado�amento	adocicamento
ado�ante	edulcorante
ado�ar	aligeirar
adquirimento	obten��o
adquirir	tirar
adquisi��o	alcance
adregar	vir
adscrever	algemar
adstringente	adstringitivo
adstringir	dobrar
adstringir-se	restringir-se
adstritivo	est�ptico
adstrito	restrito
adstrit�rio	est�ptico
adubar	assazonar
adufe	adufo
adulador	zumbaieiro
adular	engraxar
adulterado	contrafeito
adulterar	extraviar
adulterar-se	perverter-se
adultera��o	adult�rio
adulterino	contrafeito
adulto	crescido
adult�rio	burlaria
adul�o	louvaminheiro
adumbrar	debuxar
adunar-se	ajuntar-se
adurente	queimoso
adurir	incandescer
aduzir	presentar
advento	chegada
advent�cio	estrangeiro
adversar	colidir
adversativo	encontrado
adversidade	contratempo
adversor	antagonista
advers�o	tribula��o
advertido	prevenido
advertir	repreender
advertir-se	atentar
advir	realizar-se
advogado	defensor
advogar	patronear
ad�gio	prov�rbio
aera��o	arejo
aerobata	aer�bata
aer�fero	aer�faro
afabilidade	suavidade
afadigado	afanado
afadigar	pregar
afadigoso	estafante
afagado	mimado
afagar	mimar
afagar-se	apascentar-se
afago	favorecimento
afagoso	amimador
afagueiro	festeiro
afainar-se	azafamar-se
afalcoar	estimular
afaluado	afobado
afamado	egr�gio
afamar	celebrizar
afamar-se	resplender
afamilhar-se	juntar-se
afamiliado	maridado
afanado	fatigado
afanar	ladroar
afanar-se	aplastar-se
afanoso	fatigante
afarelar	desmiu�ar
afastado	retirado
afastamento	apartada
afastar	retirar
afastar-se	alhear-se
afazer	avezar
afazer-se	costumar-se
afazeres	tarefas
afear	desadornar
afeiar	desguarnecer
afei�oado	unido
afei�oamento	queren�a
afei��o	predile��o
afeminado	amulherengado
afeminar	feminizar
aferar	marfar
aferido	comparado
aferidor	afilador
aferir	balan�ar
aferrado	insistente
aferrar	aportar
aferrar-se	empeiticar
aferrenhar-se	empeiticar
aferretoar	agulhar
aferro	agarra��o
aferroar	maltratar
aferrolhar	enclausurar
afervorar	despertar
afetar	irritar
afetar-se	prejudicar-se
afeta��o	soberba
afetividade	quer�ncia
afetivo	namorado
afetuoso	maternal
afet�vel	simp�tico
afiado	agu�ado
afiambrar	galanear
afian�ado	asseverado
afian�ar	assegurar
afiar	esmerilar
afigurar	tra�ar
afigurar-se	recordar
afilado	apuado
afilar	definhar
afilhado	apadrinhado
afilia��o	associa��o
afim	parecido
afinado	purificado
afinamento	perfei��o
afinar	polir
afincado	tenaz
afincamento	tenacidade
afincar-se	emperrar
afinco	reincid�ncia
afinidade	intimidade
afirmar	implantar
afixar	prender
afixo	segurado
aflado	assoprado
aflar	inspirar
aflautado	delgado
aflechar	susceptibilizar
afligente	cruci�rio
afligido	atritado
afligidor	mortificativo
afligimento	agonia
afligir	sorver
afligir-se	martirizar-se
aflitivo	dilacerante
aflito	apertado
afloramento	aplainamento
aflorar	frolar
afluir	refluir
aflui��o	ondada
afobado	azafamado
afobar	maranhar
afoba��o	az�fama
afofado	regateiro
afofar	envaidar
afogadura	afogo
afogar	dependurar
afogar-se	melar-se
afogo	atropela��o
afogueamento	caldeamento
afoguear	ruborizar
afoitar	estimular
afoitar-se	afoutar-se
afoiteza	atrevimento
afoito	long�nime
afonsino	velho
aforado	enfiteuticado
aforar-se	avocar-se
aforia	infertilidade
aforismal	afor�stico
aformosar	vestir
aformoseamento	aformosentamento
aformosear	embrincar
aformosear-se	engalanar-se
aformosentamento	ataviamento
aformosentar	ajaezar
aforrar	cumular
aforro	liberta��o
afortalecer-se	retemperar-se
afortalezar	oxigenar
afortalezar-se	refugiar-se
afortunado	fasto
afoutar-se	enfeitar-se
afouteza	coragem
afouto	teso
afracado	anemiado
afregulhado	apressado
afrentar	encarar
afrescar	arrefecer
afroixado	largo
afroixar	bambar
afronta	ataque
afrontado	ofendido
afrontamento	ultraje
afrontar	estrompar
afrouxar	malear
afrouxar-se	entorpecer
afrouxelado	delicado
afumar	vaporar
afumear	esfumar
afumegar	esfumear
afundado	escavado
afundar-se	desaparecer-se
afunilar	estreitar
afuroado	escavado
afutricar	fuxicar
afuzilar	esfuziar
af�vel	amor�vel
af�	labuta
agachado	alapardado
agachamento	encolhedela
agachar-se	encafuar-se
agadanhar	esfolar
agadunhado	furtado
agafanhar	unhar
agaiatado	malicioso
agalanado	esquipado
agalegado	rude
agalinhar-se	estarrecer-se
agaloar	enaltecer
agarra	agarra��o
agarrar	garrear
agarrar-se	filar-se
agarra��o	agarramento
agasalhado	enconchado
agasalhar	velar
agasalhar-se	recobrir-se
agasalho	pousada
agastadi�o	tomadi�o
agastado	enraivecido
agastamento	arrelia
agastar-se	embravear-se
agatinhar	gatinhar
agenciador	laborioso
agencioso	ativo
agenda	caderneta
agente	propulsor
agermanar-se	envolver-se
agigantado	escomunal
agigantar	ampliar
agigantar-se	gigantear
agigantear	agravar
agigantear-se	gigantear
agilidade	dinamismo
agitado	fremente
agitador	agitante
agitar	desassossegar
agitar-se	sacudir-se
agita��o	fogo
agito	alvorotamento
aglomerado	coacervado
aglomerar	lotar
aglomerar-se	associar-se
aglomera��o	concentra��o
aglutinante	aglutinativo
aglutinar	pegar
agoirar	profetizar
agonia	decad�ncia
agoniado	amargado
agoniar	ansiar
agonizar	boquear
agourar	saber
agourento	ominoso
agouro	progn�stico
agracia��o	galardoamento
agradar	alegrar
agradar-se	deleitar-se
agradecer	gratular
agrado	prazimento
agrad�vel	macio
agravamento	aumento
agravar	recrudescer
agredir	ir
agregado	ajuntado
agregar	congregar
agregar-se	consociar-se
agrega��o	associa��o
agreg�vel	coopt�vel
agremiar	ajuntar
agremiar-se	juntar-se
agressividade	combatividade
agress�o	ripada
agrestia	rudeza
agrestice	incivilidade
agricultor	arvicultor
agricultura	lavragem
agrilhoar	engranzar
agrim�nia	agrura
agrinaldar	festonar
agro	decep��o
agror	amargura
agrumelar	encaramelar
agrumelar-se	coalhar-se
agrupado	associado
agrupar	integralizar
agr�cola	arvicultor
aguaceiro	cordoada
aguar	lentar
aguardar	atender
aguaritar	albergar
agua�al	paul
agudar	desembotar
agudez	subtilidade
agudeza	fineza
aguerrido	varonil
aguilhar	concitar
aguilhoar	inflamar
aguilh�o	ati�amento
agulha	picada
agulhar	ferir
agu�ado	apuado
agu�ar	influir
ag�ncia	dilig�ncia
ag�entar	segurar
aiaia	brinquedo
aiar	ulular
ainda	demais
airado	resfriado
airosidade	donaire
airoso	digno
ajaezado	esquipado
ajaezar	vestir
ajarretar	truncar
ajaular	aprear
ajavardar	descivilizar
ajeitado	ordenado
ajeitamento	conchavo
ajeitar	congra�ar
ajoeirar	sengar
ajoelhado	genuflexo
ajoelhar-se	avassalar-se
ajorca	axorca
ajoujar	sobrecarregar
ajuda	aviamento
ajudante	auxiliar
ajudar	servir
ajudar-se	aproveitar-se
ajuizado	circunspecto
ajuizar	reputar
ajuntado	aposto
ajuntar	conchegar
ajuntar-se	grupar-se
ajustado	pactuado
ajustagem	amoldamento
ajustamento	enquadramento
ajustar	conluiar
ajustar-se	combinar-se
ajut�rio	putir�o
alabarar	foguear
aladeirado	enladeirado
alagado	arrasado
alagamar	pego
alambazado	lambaz
alambicado	enfatuado
alambicar	madurar
alambrado	aramado
alanceado	amargado
alanhar	ansiar
alanzoar	parlar
alapardado	rec�ndito
alar	guindar
alardar	galhardear
alardar-se	campar
alardeador	gabador
alardear	pracear
alardear-se	gargantear
alargar	alongar
alargar-se	amplificar-se
alarido	tumulto
alarmado	intranq�ilo
alarmar	ariscar
alarmar-se	espaventar-se
alarvado	grosseiro
alarvajado	tosco
alarvaria	chambo�ce
alarve	grosseiro
alastrar	in�ar
alba	albor
alberca	aqu�rio
albergado	instalado
albergamento	albergaria
albergar	asilar
albergaria	poisada
albicante	branquicento
albinia	albinismo
albor	arraiada
alborcar	cambar
alborotar	desassossegar
alcachinar	tornejar
alcag�etar	dedo-durar
alcance	conseguimento
alcantilado	alcantiloso
alcan�ado	atingido
alcan�amento	obten��o
alcan�ar	depreender
alcan��vel	consegu�vel
alcatroar	empezar
alcatruz	ca�amba
alcatruzado	combo
alcofar	intrigar
alcoice	prost�bulo
alcoolizado	embriagado
alcoolizar-se	melar-se
alcoranista	mu�ulmano
alcouceiro	prostibul�rio
alcovitar	mexericar
alcoviteiro	intrigante
alco�latra	bebum
alcunha	antonom�sia
alcunhar	sobrenomear
aldeia	p�voa
aldeola	casalejo
aldrava	argola
aldravice	trapa�a
aleat�rio	inopinado
alegado	referido
alegar	reportar
alega��o	arg�i��o
alegrar	animar
alegrar-se	congratular-se
alegre	travesso
alegria	j�bilo
aleijado	mutilado
aleijar	jarretar
aleiloar	leiloar
aleitamento	amamenta��o
aleive	refalsamento
alentado	encorajado
alentar	ansiar
alentoso	alto
alerta	atentamente
aleta	narina
alevantado	apanhado
alevantar	erguer
alevantar-se	pronunciar-se
alevante	levante
alfageme	espadeiro
alfaiado	engalanado
alfaiar	arrear
alfandegar	alfandegueiro
alfeire	chiqueiro
alfeninado	dengoso
alfinetada	sainete
alfobre	alfofre
alfombrar	entapetar
alforriar	forrar
algaraviada	celeuma
algazarra	babel
algemar	obrigar
algemar-se	atar-se
algibe	cacimba
algodoaria	cotonif�cio
algozaria	selvageria
alhanado	igualado
alhanar	alivelar
alhanar-se	aplanar-se
alheado	desassisado
alhear	traspassar
alhear-se	perturbar-se
alheio	inatento
aliado	associado
aliar	conjungir
alicantinador	alicantineiro
alica�do	desacor�oado
alicer�ador	fundamentador
aliciador	aliciante
aliciante	aliciat�rio
aliciar	mordicar
alienado	endoidecido
alienar	desvariar
alienar-se	enlouquecer-se
alienista	mentecapto
alien�gena	estrangeiro
aligeirado	dulcificado
aligeirar	amenizar
alijar	cuspir
alimental	nutriente
alimentar	conservar
alimentar-se	comer
alimenta��o	estimula��o
aliment�cio	substancial
alimpar	depurar
alimpar-se	depurar-se
alindado	esquipado
alinhado	nivelado
alinhavar	coser
alinho	esmero
alisar	aplainar
alisar-se	aplainar-se
alistar	relacionar
aliviado	leve
aliviar	moderar
aliviar-se	mitigar-se
aljofarar	esborrifar
aljofrar	arrociar
alma	vivacidade
almargeal	pasto
almejar	pian�ar
almiscarado	cheiroso
almofadado	estofado
alogia	disparate
aloirar	enloirecer
alojamento	instala��o
alojar	condessar
alombado	curvo
alongar	distanciar
alongar-se	prorrogar-se
alonginquar	desunir
aloucado	amalucado
aloucar	variar
alourar	enlourar
alparcata	alpercata
alquebrado	debilitado
alquebramento	debilita��o
alquebrar	sangrar
alquebrar-se	exaustar-se
altanado	alterado
altanaria	sobranceria
altaneiro	cachaceiro
altaragem	voto
altareiro	beato
alteado	encimado
altear	arribar
altear-se	subir
alterado	desinquieto
alterar	danar
alterar-se	transmudar-se
altera��o	indigna��o
altercador	altercante
altercar	testilhar
alternar	rajar
alterna��o	diversifica��o
alteroso	assoberbado
altiloq��ncia	sublimidade
altiplano	plat�
altissonante	estriduloso
altit�dico	altitudin�rio
altivamente	arrogantemente
altivez	potra
altivo	campanudo
alto	ex�mio
alt�ssono	estridoroso
aluado	destrambelhado
aluamento	doudaria
aluar-se	alucinar-se
aluarado	enluarado
alucinar	desatinar
alucinar-se	endoidecer-se
alucin�geno	t�xico
alugar	estipendiar
aluir	dirruir
alui��o	desabe
alumbrado	deslumbrado
alumbrar	clarear
alumbrar-se	iluminar-se
alumiado	esclarecido
alumiamento	luzimento
alumiar	clarear
alumia��o	ilumina��o
alumin�fero	al�nico
alusivo	concernente
alus�o	refer�ncia
aluvi�o	enchente
alu�do	desabado
alvan�u	alvenel
alvar	tolo
alvarento	entrebranco
alvear	dealvar
alveiro	entrebranco
alvejar	alvorejar
alvescer	calear
alvidramento	arb�trio
alvinitente	flam�neo
alvissarar	dar
alvo	objetivo
alvor	resplandec�ncia
alvorejar	curar
alvorescer	raiar
alvorotamento	excita��o
alvorotar	regozijar
alvorotar-se	virar
alvoroto	estrondo
alvoro�ado	alvorotado
alvoro�ar	facionar
alvoro�ar-se	pronunciar-se
al�ada	compet�ncia
al�ado	levantado
al�ar	exaltar
al�ar-se	alevantar-se
al�quota	percentualidade
al�vio	minora��o
al�vio	inunda��o
amabilidade	meiguice
amachonar	amachorrar
amachucado	depauperado
amachucar	golpear
amaciamento	amolecimento
amaciar	quebrar
amado	querido
amador	amante
amadurado	assazonado
amadurar-se	amadurecer-se
amadurecer	sutilizar
amadurecer-se	assazonar-se
amagrado	amumiado
amainar-se	refecer-se
amaldi�oar	anatematizar
amalgamar	fundir
amalucar-se	endoidecer-se
amamenta��o	lacta��o
amancebado	cambondo
amaneirado	apavonado
amanhado	esquipado
amanhar	lavrar
amansado	domado
amansar	repousar
amansar-se	controlar-se
amante	mulher
amanuense	escritur�rio
amar	copular
amarar	angustiar
amarasmado	mazorro
amarasmeado	let�rgico
amarelado	descorado
amarfanhado	amolaxado
amarfanhar	torturar
amargar	provar
amargor	amargura
amargurado	mortificado
amaricado	aqualirado
amarrado	carifranzido
amarrar-se	emperrar
amarra��o	imobiliza��o
amarroado	pensativo
amarrotado	enrugado
amasio	mancebia
amassado	espandongado
amassar	marlotar
amasso	esfregamento
amazelado	deselegante
ambicionar	ansiar
ambicioso	c�pido
ambig�idade	equivocidade
ambilateral	bilateral
ambrosiado	delicioso
ambros�aco	s�pido
ambulante	erradio
ambulativo	err�tico
amb�gio	duvidoso
amealhar	economizar
amedrontador	arrepiante
amedrontante	fero
amedrontar	intimidar
amedrontar-se	estremecer-se
ameigado	apaparicado
ameigar	ceder
ameigar-se	diminuir-se
amelindrado	ressentido
amelindrar	mazelar
amelindrar-se	irritar-se
ameninado	menineiro
ameninar	renascer
ameninar-se	rejuvenescer-se
amenizar	remitir
amenizar-se	aplacar-se
ameno	moderado
amenoso	suave
amenta	voz
amente	delirante
amergulhar-se	amodornar-se
americano	norte-americano
amesquinhador	apoucador
amesquinhar	desatender
amestrado	ensinado
amesurar	mesurar
amical	amistoso
amic�ssimo	amigu�ssimo
amigado	cambondo
amigo	unido
amimar	ber�ar
amiserar-se	mazelar-se
amisera��o	autocomisera��o
amochado	retra�do
amochar-se	enclausurar-se
amodelar	contornar
amodorrar-se	imergir-se
amoedado	opulento
amoestar	censurar
amofinado	apoquentado
amofinar	golpear
amofumbar	colorar
amoitar	ocultar
amoitar-se	entrouxar-se
amolado	saturado
amolador	maldito
amolante	paulificante
amolar	massacrar
amolar-se	entediar-se
amola��o	zanga
amoldado	moldado
amoldar-se	formar-se
amoldurado	emoldurado
amoldurar	sazonar
amoldurar-se	espenicar-se
amolecer-se	embrandecer-se
amolegar	amolgar
amolestar	vulnerar
amolestar-se	escandalizar-se
amolgar	prostrar
amolgar-se	cair
amolga��o	amolgadura
amontoado	poupado
amontoamento	sobreposi��o
amontoar	conglobar
amoquecar-se	intimidar-se
amor	carinho
amor-pr�prio	auto-estima
amorcegar	mungir
amorda�ar	emorda�ar
amorenado	bronzeado
amorenar	atrigueirar
amorenar-se	tostar-se
amorfanhar	encouchar
amoriscar-se	apassionar-se
amorosamente	ternamente
amoroso	caro�vel
amortecer	placar
amortecer-se	esmaecer
amortecido	morti�o
amortificar	temperar
amor�vel	queren�oso
amostrar	indicar
amostrar-se	repontar
amota	marach�o
amotinar	atumultar
amotinar-se	insubordinar-se
amotina��o	levante
amover	despojar
amov�vel	remov�vel
amparado	resguardado
amparar	estacar
amparo	asilo
ampliar	dilatar
amplia��o	crescimento
amplid�o	vastid�o
amplificador	aumentador
amplificar	delongar
amputar	cercear
amuado	embezerrado
amuar	repanhar
amuar-se	entufar-se
amulatar	atrigueirar
amulatar-se	bronzear-se
amulherado	inviril
amunicionar	municiar
amurchecer	desflorescer
am�sio	amigo
am�vel	caro�vel
anacor�tico	lauretano
anafado	luzidio
anafrodisia	impot�ncia
analg�sico	an�lgico
analisar	farejar
analogia	conformidade
ananicado	calhorda
anano	an�zado
anarquia	babil�nia
anarquizado	bagun�ado
anarquizar	destemperar
anatematiza��o	excomunga��o
ancho	enfatuado
ancorado	surto
ancoradouro	fundeadoiro
ancorar	fundear
anc�pite	indeliberado
andadeiro	andeiro
andado	decorrido
andaina	fileira
andamento	seguimento
andar	operar
andarengo	andeiro
andarilhar	vagabundear
andejo	err�tico
andrajoso	pelintra
andr�mina	artif�cio
anegrado	negrusco
anelar	desejar
anelo	�nsia
anemiado	enfraquecido
anemiar	consumir
anemizar	fragilizar
anestesiar	narcotizar
angariar	conseguir
angelical	ang�lico
angloman�aco	angl�mano
angurriado	esuriente
angurriento	fam�lico
angustiado	confrangido
angustiar	mortificar
angustiar-se	apoquentar-se
ang�stia	sofrimento
ang�iforme	serpentinado
anhanho	lamb�o
anichar-se	entrouxar-se
anilado	azulado
animado	espigaitado
animador	confortador
animadvers�o	ripada
animalizar-se	bestializar-se
animar	bafejar
anima��o	vibra��o
animosidade	desintelig�ncia
animoso	brioso
aninar	ninar
aninhar	encafurnar
aninhar-se	encafurnar-se
anipnia	insonol�ncia
aniquilado	apeado
aniquilamento	profus�o
aniquilar-se	evaporizar-se
aniquila��o	elimina��o
anoitecer	noitinha
anojadi�o	azougado
anojado	enfastiado
anojar	entediar
anojar-se	nausear-se
anojoso	nojoso
anorg�nico	inorg�nico
anortear	guiar
anotar	titular
anoutar	noitecer
ansiado	cobi�ado
ansiar	later
antagonismo	paradoxalidade
antagonista	concorrente
antag�nico	contradit�rio
antealvorar	matinar
antecedente	anterior
antecessor	antepassado
antecontrato	pr�-contrato
antedito	predito
antedizer	pressentir
anteferir	preferir
antel�quio	pref�cio
antepor	preferir
antepor-se	repulsar
anteriormente	atr�s
antes	mais
antes-tempo	antetempo
antever	presumir
antevid�ncia	previd�ncia
antibr�mico	desodorizante
antidemocrata	antidemocr�tico
antiformoso	feio
antiib�rico	antiiberista
antipatia	desintelig�ncia
antipatizar	implicar
antipo�tico	apo�tico
antip�tico	contr�rio
antiquado	antiqu�rio
antiquar	desatualizar
antit�tico	oposto
antojar	imaginar
antologia	sele��o
antologiar	respigar
antro	fojo
antrop�ide	hom�nido
anulado	cassado
anulador	nulificante
anular-se	desgregar-se
anula��o	inutiliza��o
anul�vel	nulific�vel
anunciar	expedir
anuncia��o	participa��o
anuviar-se	encangotar-se
an�lise	explora��o
an�rquico	bagun�ado
an�tema	excomunga��o
an�mico	frouxo
an�dino	f�til
an�ncio	vatic�nio
apacificar	desencrespar
apadrinhar	soprar
apagamento	expun��o
apagar	debotar
apaixonado	fan�tico
apaixonante	sedutor
apaixonar-se	embei�ar-se
apalavrado	concertado
apalavrar-se	empenhorar-se
apalear	aporretar
apalermado	tolo
apalpar	farejar
apalpa��o	tateamento
apancadado	tonto
apancado	est�lido
apandilhar-se	deslustrar-se
apanhado	levantado
apanhar	apropriar-se
apaniguar	sorrir
apara	maravalha
aparado	aposto
aparamentado	ornamentado
aparamentar	colorizar
aparamentar-se	espenicar-se
aparar	tosar
aparatar	ornamentar
aparato	ostenta��o
aparecer	sair
aparecimento	eclos�o
aparelhado	preparado
aparelho	utens�lio
aparentar	dissimular
aparente	paralelo
apari��o	fantasmagoria
apartamento	solid�o
apartar	remover
apartar-se	fugir
aparte	interrup��o
aparvado	apatetado
aparvalhado	extasiado
aparvalhar-se	desnortear-se
aparvanhado	apatetado
aparvoado	mazanza
aparvoar	zonzar
apar�ncia	cara
apascentar	espairecer
apascentar-se	folgazar
apassionar-se	enamorar-se
apassivante	apassivativo
apatetado	tolo
apatia	frouxid�o
apaulado	lutoso
apaulistanizar	apaulistar
apavesar-se	envaidar-se
apavonado	vanglorioso
apavonar	ufanar
apavonar-se	endeusar-se
apavorado	despavorido
apavorador	aterrador
apavorante	aterrador
apavorar	espavorizar
apavorar-se	intimidar-se
apavorizar	aterrorizar
apaziguador	pacificador
apaziguamento	harmonia
apaziguar	tranq�ilizar
apeado	dispensado
apear	desfabricar
apedrar	lapidar
apedrejado	ofendido
apedrejar	xingar
apegado	pegado
apejar	vedar
apejar-se	oscilar
apelar	recorrer
apelidado	denominado
apelidar	titular
apenas	levemente
apender	apensar
apendoar	pendoar
apensar	apor
apepinar	tourear
aperaltar	janotear
aperceber	entabular
apercebido	providente
aperfei�oamento	aprimoramento
aperfei�oar-se	requintar-se
aperiente	ecfr�tico
aperrar	insistir
apertado	atribulado
apertar	sotrancar
aperto	mis�ria
apertura	rascada
apessoado	bem-vestido
apestar	viciar
apetecer	satisfazer
apetec�vel	convidativo
apezinhar	desconsiderar
ape�onhado	venenoso
ape�onhar	empe�onhentar
ape�onhentado	pe�onhento
ape�onhentar	desvirtuar
apica�ar	puxar
apiedado	pio
apimentado	quente
apinhar-se	enxamear-se
apisoar	suplantar
apitar	ciciar
aplacador	pacificador
aplacamento	contemporiza��o
aplacar	serenar
aplacar-se	placar-se
aplaca��o	contemporiza��o
aplainar	laxar
aplainar-se	igualar-se
aplanado	chapado
aplanar	desentaipar
aplastar	esbofar
aplastar-se	cansar-se
aplaudido	laureado
aplauso	aprova��o
aplausos	palmas
aplicar	empregar
aplica��o	uso
apocal�ptico	intrincado
apocal�tico	informe
apodar	debicar
apoderado	apossado
apodo	zombaria
apodrecer	desconsertar
apodrecer-se	transviar-se
apodrecido	decomposto
apoiar	laurear
apoiar-se	escudar-se
apoio	escora
apojar	tufar
apologizar	desculpar
apoltronar-se	refestelar-se
apolvilhar	empoar
apontado	sugerido
apontamento	indigita��o
apontar	extravasar
apontoar	estear
apoquentado	atormentado
apoquentar	causticar
apoquentar-se	molestar-se
apor	incorporar
aporfiar	questionar
aporreado	espancado
aporreamento	raladura
aporrear	cauterizar
aporretar	derrear
aportar	desembarcar
aposentado	inativo
aposentar	recolher
aposento	morada
apossado	apropriado
apossar-se	entrar
apossear-se	assaltear
aposta	jogo
apostema	intumesc�ncia
apostemar-se	remorder-se
apostila	apostilha
apostolizador	evangelizador
apoteotizar	glorificar
apoucado	triste
apoucar	decair
apo�tico	despo�tico
apragatado	prudente
aprazado	procrastinado
aprazenteiro	aprazerado
aprazer	deliciar
apraz�vel	sonoro
aprear	confinar
apreciado	avaliado
apreciar	examinar
aprecia��o	crit�rio
apreci�vel	assinal�vel
apreender	desconfiar
apreensivo	preocupado
apregoar	disseminar
aprendido	decorado
aprendizado	tiroc�nio
apresentar	propor
apresenta��o	cara
apressadamente	rapidamente
apressurar-se	mexer-se
aprestado	preste
apresto	avio
apre�ante	apreciador
aprimorar	facetar
aprimorar-se	lapidar-se
aprisco	ovil
aprisionar	pegar
aprofundar	desencovar
aprontamento	aprontes
aprontar	vencer
apropositado	pertinente
apropositar	justar
apropriado	pr�prio
aprovar	simpatizar
aproveitamento	pr�stimo
aproximar	conjungir
aproximar-se	puxar
aproxima��o	encontro
aprumar-se	perfilar-se
aprumo	sobran�aria
apuado	pontiagudo
apuamento	penit�ncia
apunhalar	frechar
apunhar	manear
apupada	assoviada
apupado	assoviado
apurado	requintado
apurar	procurar
apurar-se	lapidar-se
apurativo	deters�rio
apuro	embara�o
apurpurado	purpurejante
apurpurar	vermelhar
ap�tico	indolente
aquartelar-se	instalar-se
aquebrantar	infringir
aquecer	indignar
aquecer-se	chispar
aquecido	encanzinado
aquedar	paziguar
aquentamento	esquenta��o
aqueronteu	trevoso
aquer�ntico	sombrio
aqui	c�
aquiescer	assentar
aquietado	serenado
aquietar	pacificar
aquietar-se	sossegar-se
aquilonar	setentrional
aquinhoar	prover
aquisi��o	conquista
ar	tom
aragem	bafejo
aramista	equilibrista
aranzel	cantilena
arauto	intern�ncio
arbitr�rio	discricional
arboriza��o	arvoragem
arcaboi�ar	esbo�ar
arcabou�ar	riscar
arcado	arqueado
arcaico	cedi�o
arca�stico	perempto
arcebispado	arquidiocese
archote	luzeiro
ardejar	chamear
ardente	caloroso
ardentia	fervor
arder	pian�ar
ardido	arrojado
ardidoso	cadimo
ardil	tra�a
ardileza	raposia
ardiloso	sonso
ardor	brasa
arduidade	laboriosidade
ardume	queimor
ard�ncia	caldea��o
areado	desorientado
arear	estrovinhar-se
arejo	refrescamento
arenga	discurso
arengar	pugnar
arenguear	rezingar
arengueiro	enredeiro
aresteiro	jurisprudente
are�sco	areoso
arfada	palpite
arfadura	arfagem
arfar	jogar
argentado	prateado
argileira	barreiro
argueiro	pisca
argumentar	renhir
argumenta��o	debate
argumento	contexto
arg�cia	transcend�ncia
arg�ir	porfiar
arg�i��o	imputa��o
aridez	aspereza
ariscar-se	assustar-se
arisco	rebelde
aristocracia	nata
arlequim	palha�o
armadilha	espera
armado	encoira�ado
armar	maquinar
armaz�m	mercearia
arma��o	montagem
armipotente	mav�rtico
aro	c�rculo
aromado	odor�fico
aromal	fragrante
aromalizar	balsamar
aromatizado	moscado
aromatiza��o	embalsamamento
aromoso	moscado
arom�tico	olorante
arpear	arpoar
arqueado	combo
arqueadura	encurvamento
arqueamento	dobramento
arquear	envergar
arquejar	lufar
arque�vel	flex�vel
arquitetado	edificado
arquitet�nica	arquitetura
arquivamento	sobrestamento
arquivar	encerebrar
arquivo	auto
arrabalde	sub�rbio
arraigar	implantar
arrampado	ladeira
arrancada	egress�o
arrancadura	surto
arrancar	sufocar
arranhar	raspar
arranh�o	rasp�o
arranjado	organizado
arranjar	restabelecer
arranjar-se	avir-se
arrapinar	escamotar
arrasado	devastado
arrasador	assolador
arrasar	carregar
arrastar	pregar
arrastrar	impelir
arrazoado	razoado
arrazoar	especular
arreado	empenado
arrear	vestir
arrear-se	fanfarronar
arreata	reata
arrebanhador	pegureiro
arrebanhar-se	consociar-se
arrebatado	desembestado
arrebatamento	fogosidade
arrebatar	palmear
arrebatar-se	encruar-se
arrebentado	mo�do
arrebentar	desabar
arrebitar	rebater
arrebitar-se	envinagrar-se
arrebito	imod�stia
arredado	derivado
arredar	desconchegar
arredio	tresmalhado
arredondado	boleado
arredondamento	harmoniza��o
arredondar	inteirar
arrefecer	comutar
arrefecer-se	esfriar-se
arrefentar	torpecer
arrefe�ado	desentonado
arrefe�ar	baratear
arregalar-se	esbugalhar-se
arreganho	desassombro
arrega�o	esfrega
arregoar	sulcar
arreigado	cr�nico
arreigar-se	inviscerar
arrelia	zanga
arreliar	encalmar
arreliar-se	irritar-se
arreliento	pendenciador
arrelioso	rusguento
arrelvar	relvejar
arrematar	inteirar
arremata��o	remata��o
arremate	fecho
arremedo	macaquea��o
arremenicar	retorquir
arremessado	desconsiderado
arremessar	propelir
arremetedor	arremetente
arremetedura	arrojamento
arremeter	opugnar
arremetimento	remetida
arrenegar	descrer
arrenega��o	trai��o
arrenego	renuncia��o
arrepanhado	encascorado
arrepelador	arrepelante
arrepela��o	ulo
arrependido	compungido
arrependimento	metan�ia
arrepiado	h�spido
arrepiamento	erri�amento
arrepiar	eri�ar
arrepiar-se	enchoiri�ar-se
arrevesado	nebuloso
arrevesar	inverter
arrevessar	lan�ar
arriar	desesperar
arribadi�o	estrangeiro
arribana	rancho
arribar	recobrar
arrijar	inteiri�ar
arrimar-se	jogar
arrincoar	estacionar
arrinconar	enrinconar
arrinconar-se	encantoar-se
arriosca	lud�brio
arriscado	venturoso
arriscar	expor
arriscar-se	ousar
arri�ar	encarni�ar
arri�ar-se	encrespar-se
arrochada	taca
arrocho	qu�
arrociar	relentar
arrodear	rondear
arrodelar-se	cobrir-se
arrogante	corajoso
arrog�ncia	incha��o
arrojado	int�rrito
arrojamento	dardejamento
arrojar	sacudir
arrojar-se	atrever-se
arrojo	lan�amento
arrolado	enovelado
arrombamento	depreda��o
arrombar	quebrar
arrostar	desafiar
arrotar	galhardear
arrotear	surcar
arroubar-se	embevecer-se
arroxeado	roxeado
arrozal	arrozeira
arrrocho	torcedor
arruaceiro	bagunceiro
arrua�ador	rusgador
arrufado	hirto
arrufar-se	enchoiri�ar-se
arrugado	enrugado
arruinador	prodigalizador
arruinar	avariar
arrumar	expelir
arruma��o	tessitura
arrunhar	lacerar
arrupiar	enoiri�ar
arru�	atravessado
arte	safadice
arteiro	maquiav�lico
artes�o	artista
articular	concatenar
articula��o	uni�o
artificioso	inatural
artimanha	raposice
artista	sonso
arvoado	torvado
arvoamento	desorienta��o
arvoar	desconcertar
arvorado	i�ado
arvorar	ostentar
ar�ola	resplandor
asca	enojamento
ascendente	ascens�vel
ascend�ncia	predomin�ncia
asco	enfaro
ascoroso	nauseabundo
aselha	fivela
asfaltagem	asfaltamento
asfixiador	asfixioso
asfixiante	asf�xico
asfixiar	reduzir
asfixiar-se	esganar-se
asilar	hospedar
asilar-se	hospedar-se
asinino	bordalengo
asin�rio	manco
asnal	be�cio
asneira	babugeira
asnidade	bestice
asnil	bo�al
aspado	aspeado
aspecto	tra�o
asperger	despargir
aspergido	borrifado
aspergir	desparzir
asperidade	crespid�o
aspirado	disputado
aspira��o	idealiza��o
asqueroso	balordo
assacar	referir
assaltada	saltada
assaltar	lembrar
assaltear	tomar
assanhadi�o	violento
assanhado	sanhoso
assanhamento	atiramento
assanhar	derrancar
assanhar-se	encolerizar-se
assar	queimar
assassinar	destruir
assass�nio	mortic�nio
assazoar	revestir
assazonar-se	requintar-se
asseado	delicado
assear	limpar
assecla	partid�rio
assedentado	sequioso
assediador	assediante
assediar	enrolar
assegurar	segurar
assegurar-se	fundar-se
asselvajado	rude
assembl�ia	tert�lia
assemelhar	parecer-se
assenhorear-se	senhorear
assenso	deferimento
assentado	encravado
assentamento	firma��o
assentar	pressupor
assentar-se	sedimentar-se
assente	determinado
assento	base
asserenar	calmar-se
assetar	detrair
assetear	mortificar
assiduamente	reiteradamente
assiduidade	presen�a
assimilar	entender
assim�trico	dissim�trico
assinado	determinado
assinalado	�nclito
assinalar	impor
assinal�vel	not�vel
assinar	tra�ar
assistido	auxiliado
assistir	demorar
assoado	esmoncado
assoalhar	dar
assoberbado	imponente
assoberbante	fatigante
assoberbar-se	desvanecer-se
assobiado	assoviado
assobio	silvo
associado	emparceirado
associar	vincular
associar-se	consociar-se
associa��o	congrega��o
assolapar	desmelhorar
assola��o	vasta��o
assomada	pique
assomadi�o	irritadi�o
assomado	atrabilioso
assombrado	sombroso
assombrar	assustar
assombrar-se	pasmar-se
assombra��o	assombro
assombrear	entrevar
assombro	temor
assombroso	estranho
assomo	ind�cio
assoprado	campanudo
assossegar-se	quietar-se
assovelado	provocado
assuada	balb�rdia
assustado	titubante
assustador	terr�vel
assustar	aterrorizar
assustar-se	espaventar-se
ass�dio	insist�ncia
aster�ide	estrel�rio
astilha	estila
astral	�streo
astroso	sombrio
astucioso	espertalh�o
astuto	fin�rio
ast�cia	subtileza
atabalhoado	enleado
atabalhoamento	pipoco
atacoado	atamancado
atado	preso
atadura	pris�o
atafulhado	espadongado
atalaia	vedeta
atalho	senda
atamento	ligadura
atapetar	carpetar
ataque	salteada
atar	embirar
atarantadamente	tontamente
ataranta��o	salsada
atarraxar	tarraxar
atascal	lameiro
atassalhado	espeda�ado
atassalhar	retalhar
ataviado	engalenado
ataviar	ornamentar
ataviar-se	embonecar-se
atemorizar	intimidar
atempado	ca�do
atenciosamente	polidamente
atencioso	desempoado
atender	ver
atend�vel	cab�vel
atentar	desafiar
atenuado	langoroso
atenuar	suavizar
atenua��o	refrescamento
aten��o	zelo
aterrar	poisar
aterrar-se	estremecer-se
aterrorizador	terrorizante
aterrorizante	fero
atesar	endurar
atesar-se	entabuar-se
atestado	atulhado
atestar	fartar
atilado	maduro
atilamento	precau��o
atilar-se	sazonar-se
atinado	ponderado
atinar	notar
atingir	fisgar
atiramento	remetida
atirar	disparar
atirar-se	derrocar-se
atitar	ciciar
atitude	comportamento
ativado	excitado
atividade	dinamismo
ativo	laborioso
ati�ar	espica�ar
atoarda	balela
atocaiar	esquadrinhar
atochado	comprimido
atochar	atrapachar
atolar-se	envasar-se
atoleiro	tijuco
atomizador	nebulizador
atontado	estonteado
atontar	estontecer
atontear	azamboar
atopetado	repleto
atopetar	lotar
atordoado	atrapalhado
atordoar	azoratar
atormentado	magoado
atormentar	chicotar
atormentativo	escruciante
atrabilioso	iracundo
atrabili�rio	tomadi�o
atracar	garrear
atraca��o	embate
atraente	fascinante
atraidor	fascinador
atrair	envolver
atrai�oado	engazopado
atrai�oar	malsinar
atrancamento	atravancamento
atrancar	empancar
atranqueirar	impedir
atrapachar	ingurgitar
atrapalhado	avoado
atrapalhar	perturbar
atrasador	retardador
atrasar	lerdear
atrasar-se	deter-se
atraso	revers�o
atrativo	poesia
atravancar	congestionar
atravanco	estorvo
atravessado	sinistro
atrav�s	transversalmente
atra��o	desejo
atreito	chegado
atrelar	vencer
atrever-se	botar-se
atrevido	audaz
atrevimento	prot�rvia
atribulado	doloroso
atributado	tributado
atributo	qualidade
atrincheirar	envalar
atristar	ofender
atristar-se	penar-se
atristurado	mazorro
atritado	mortificado
atritar-se	desamistar-se
atrito	cisma
atro	h�rrido
atroada	bulha
atroador	atroante
atroante	tonitruante
atroar	desatremar
atrocidade	monstruosidade
atrofiador	atrofiante
atrofiamento	entrevecimento
atropelar	enlabirintar
atropelar-se	mexer-se
atroz	lacerante
atro�oar	migalhar
atualidade	dia
atualizar	renovar
atuar	sugestionar
atua��o	feito
atufar	entupir
atufar-se	meter-se
atumultar	convulsar
atumultuar	desarrumar
aturado	seguido
aturar	comportar
aturdido	estupefeito
aturdir	enzonzar
at�nito	tolo
audacioso	long�nime
audaz	long�nimo
auditor	ouvidor
aud�cia	desembara�o
auferir	ter
augurar	conjecturar
augusto	brilhante
aug�rio	progn�stico
aumentar	avantajar
aumentar-se	intensificar-se
aura	sopro
aureolar	circular
auricomado	aur�como
aurifulgente	aurisplendente
aurirrubro	aurorrubro
aur�fico	dourado
auspiciar	saber
ausp�cio	predi��o
austeridade	rudeza
austero	prudente
aus�ncia	retiro
autarca	auto-suficiente
autarquia	autocracia
autenticar	validar
autenticidade	lidimidade
auto-estima	auto-respeito
autoctonia	autoctonismo
autom�vel	ve�culo
autopsial	aut�ptico
autoritarismo	despotismo
autorit�rio	sentencioso
autoriza��o	benepl�cito
aut�ctone	ind�gena
aut�geno	end�geno
aux�lio	fortifica��o
avaliar	enxergar
avantajado	grande
avantajar-se	galrar
avantesma	visagem
avan�amento	avan�o
avan�ar	vingar
avan�o	vantagem
avarento	avaro
avareza	mesquinharia
avariar	estrompar
avaro	sovina
avassalado	submetido
avassalamento	exterm�nio
avassalar	superar
aveado	azoratado
avelhado	avelhantado
avelhentado	malconservado
aveludado	veludado
avenado	azoratado
aventado	lembrado
aventar	refrescar
aventura	perip�cia
aventureiro	perigoso
aventuroso	bendito
averdengado	verdeal
avergar	sofrear
avergar-se	tornejar-se
avergoado	maltratado
averiguar	buscar
averigua��o	estudo
avermelhado	vermelhusco
avermelhar	purpurear
avernal	infernal
averso	desafeto
avers�o	enj�o
avexar	torturar
aviamento	preparativo
avidez	insaciabilidade
avigorar	potencializar
aviltado	depreciado
aviltador	degradante
aviltamento	vileza
aviltante	humilhante
aviltar	humlhar
aviltar-se	injuriar-se
avincar	dobrar
avinhar	embebedar
avinhar-se	toldar-se
avir	enla�ar
avisado	cauto
avisar	premunir
aviso	informe
aviventar	reanimar
avizinhar-se	conchegar-se
avi�rio	avicul�rio
avoado	confundido
avolumar	inflar
avolumar-se	espessar-se
avultado	corpudo
avultar	desremediar
av�rneo	infernal
axial	ax�ide
axioma	gnoma
azagaia	zagaia
azangar	incomodar
azar	desfortuna
azebrado	azinabrado
azedado	exacerbado
azedar	estomagar
azedar-se	desenfrear-se
azedia	pique
azedo	fermentado
azedume	pesadume
azeitoso	graxo
azevieiro	libertino
azoada	babar�
azoeirado	embara�ado
azoratado	gira
azoratar	desarvorar
azoretar	estontecer
azorragada	lamborada
azorragar	chibatar
azorraguear	zurzir
azougado	genioso
azougar	preocupar
azucrinado	incomodado
azucrinante	importuno
azucrinar	irritar
azul	�brio
azul-do-c�u	c�rulo
azulejador	ladrilheiro
azul�neo	azurino
azumbrado	corcovado
azuretar	desatremar
a�acalado	acicalado
a�aimar	medir
a�aime	a�ame
a�aimo	a�amo
a�ambarcagem	a�ambarque
a�ambarcar	atravessar
a�odamento	alvoroto
a�odar	apica�ar
a�oiteira	chicote
a�orado	apetitoso
a�outar	chibatear
a�oute	flagelo
a�outeira	rebenque
a�ucarado	dulcificado
a�ucarar	dulcificar
a�ude	mota
a�ular	prurir
a��o	demanda
a��car	suavidade
a�va	chu�
baba-ovo	lambe-botas
babaca	bab�o
babador	babeiro
babaquara	piraquara
babaquice	tontice
babar�	babar�u
babel	pandem�nio
babelizar	desajustar
baboseira	bajoujice
baboso	lamb�o
babugeira	sarambelada
babugem	quiquiriqui
babujar	borri�ar
bab�o	palon�o
bacanal	libertinagem
bacante	t�ade
bacelo	vide
bacharelada	bacharelismo
bacharelice	culteranismo
bacia	braseiro
bacorejar	prever
bacorejo	intui��o
bacorinho	leit�o
bacteriano	bact�rico
badalar	toar
badalar-se	promover-se
badalejar	tinir
badameco	pequenote
badanal	balb�rdia
baderna	caterva
badernar	fandanguear
baderneiro	badernista
badernista	desordeiro
badulaque	penduricalho
badulaques	cacar�us
bad�	chapet�o
bafagem	z�firo
bafejar	encorajar
bafejo	brisa
bagaceira	enga�o
bagana	bituca
bagatela	nada
baga�o	enga�o
bagualada	incivilidade
baguncear	fandanguear
bagun�ado	ca�tico
bagun�ar	pandegar
baia	boxe
baianidade	baianismo
bailado	dan�a
bailarim	dan�arino
bainhar	bordar
baiuqueiro	taberneiro
baixa	declina��o
baixar	cortar
baixeza	lab�u
baixio	parcel
baixo	convidoso
bai�ca	bodega
bajoujo	parvo
bajulador	zumbaieiro
bajular	lamber
bajula��o	louvaminha
balancear	comparar
balanquear	pespontar
balan�ar	cotejar
balan�o	sacolejo
balbuciar	tartamelear
balburdiar	confundir
balb�cie	tartamudeio
balb�rdia	pandem�nio
balcedoso	lameirento
balceiro	balseiro
balc�o	sacada
baldaquino	sobrec�u
balde	ca�amba
baldear	golfejar
baldio	improducente
baldo	carente
baldrocado	mistificado
baldrocar	tapear
balela	boato
balizar	sinalar
balnear	banhar
balne�rio	terma
balofo	corpulento
balordo	manco
balou�ado	embalado
balroar	preliar
balsamizar	embalsamar
bals�mico	perfumoso
bal�o	esfera
bambaleadura	boleamento
bambalear	sacudir
bambalear-se	rebolir-se
bambaleio	bamboleadura
bambalh�o	preguicento
bambear	esbambear
bambeza	languidez
bambo	lasso
bamboar-se	remexer-se
bamboleante	gingante
bambolear	sacudir
bambolear-se	requebrar-se
bamb�	bruega
banal	nulo
banana	pateta
bancarrota	debacle
banda	parte
bandada	pelot�o
bandarra	r�fio
bandarrear	mariolar
bandear-se	passar-se
bandeira	emblema
bando	turba
bandurrear	bestar
banguela	benguela
bangular	pervagar
banha	chorume
banhar	embeber
banhar-se	lavar-se
banho	lavadura
banido	refugiado
banir	desconjurar
banzado	pasmado
banzar	remoer
banzativo	penseroso
baque	colis�o
baquear	esfazer
barafunda	desordem
baralhada	rond�o
baralhamento	permist�o
baralhar	desordenar
baratar	desvalorizar
barateado	regateado
baratear	envilecer
barato	prosaico
barbante	negalho
barbear-se	raspar-se
barb�rico	bruto
barcada	barcagem
barda	tapagem
barganha	pechincha
barganhado	permutado
barquear	barquejar
barqueiro	catraieiro
barraca	tenda
barracar	enrinconar
barral	barreira
barranca	barranco
barrar	engarrafar
barreirar	envalar
barrela	coada
barrete	casquete
barrica	vasilha
barril	vasilha
barrufar	pingar
barulhar	estourar
barulho	ostenta��o
barulhoso	rumoroso
base	funda��o
basear	firmar
basear-se	estear-se
basilar	essencial
bastardear	degenerar
bastida	estacada
bastonada	bordoada
bast�o	denso
batalha	torneio
batalhador	pelejador
batalhar	militar
batalh�o	rancho
batelada	chorrilho
bater	delombar
batida	rebordosa
batido	calcado
batina	samarra
batoque	gargaleira
batotar	trapacear
batueira	tamboera
batumado	encrespado
bat�rio	beataria
bazofiador	pimp�o
bazofiar	galrar
baz�fia	ostenta��o
beataria	beatismo
beatice	beatismo
bebedeira	embriagamento
bebedor	cachaceiro
beber	libar
beberar	infiltrar
beberes	bebes
beberraz	beberrote
beberricar	pingolar
beberrote	cachaceiro
bebida	l�quido
bebido	emborrachado
bedelhar	cavaquear
beija-flor	colibri
beijar	oscular
beira	vizinhan�a
beirar	brolar
beleguim	quadrilheiro
beleza	diva
beliscado	incitado
beliscadura	morseg�o
beliscar	estugar
belo	suave
belver	miradoiro
bem	felicidade
bem-afortunado	fortunoso
bem-arranjado	bem-parecido
bem-aventurado	fortunoso
bem-aventuran�a	fortuna
bem-composto	bem-vestido
bem-criado	fino
bem-ditoso	fortunoso
bem-ouvido	submisso
bem-parecido	bonito
bem-proporcionado	esbelto
bem-querer	estimar
bem-sonante	sonoro
beneficiado	favorecido
beneficiar	restabelecer
benefici�rio	favorecido
benef�cio	gra�a
benemer�ncia	m�rito
benem�rito	insigne
benevolente	bondoseiro
benevol�ncia	bondade
benfazente	favor�vel
benfeitoria	melhoramento
bengalada	sarrafada
benigno	indulgente
benquistar	compor
benquisto	estimado
bentinho	escapul�rio
ben�oar	favonear
ben�fico	bondoseiro
ben�volo	indulgente
berloque	pendericalho
berrante	clamador
berrar	estrilar
berregante	clamador
berregar	expluir
berreiro	grita
berro	urro
ber�o	p�tria
besta	rombo
bestalh�o	boboca
bestar	vagar
bestear	zanzar
bestial	desalmado
bestializar-se	embrutecer-se
bestice	burricada
bestificado	estupefeito
bestificamento	emparvamento
betar	marchetar
betumar	betuminizar
bexigar	trotear
bezerra	novilha
bichado	empedrado
bifar	larapiar
bifurcar	derivar
bigodear	chala�ar
bigorrilha	tracambista
biliar	bilioso
biliard�rio	multimilion�rio
biliteral	bil�tero
bilontragem	vergalhada
biltre	vil�o
bimar	b�mare
bimbalhar	dar
binar	biscantar
biografia	vida
biografista	bi�grafo
biqueira	goteira
biraia	megera
biricera	miudeza
birote	pericote
birra	mau-humor
birrar	encavacar
birrento	embirrento
bisbilho	m�rmur
bisbilhoteiro	coscuvilheiro
bisonho	principiante
bispar	surrupiar
bissocia��o	trocado
bituca	ponta
bizarrear	gabar-se
bizarria	gala
bizarrice	extravag�ncia
bizarrismo	extravag�ncia
bizarro	long�nime
blague	sal
blasfemo	insultuoso
blasonador	bufador
blasonar	parlapatear
blindado	encoura�ado
bloquear	proibir
bloqueio	trava
boato	voz
bobeira	tontaria
bobice	�bia
bobinar	embobinar
bobo	patau
boboca	paspalh�o
boca-rota	boquirroto
bocadinho	peda�o
bocejar	oscitar
bochincheiro	rusguento
bochornal	calmo
bochornoso	sufocante
boc�	zote
bodega	cevadeira
bodoso	embodegado
bodum	fartum
bofar	resfolegar
bofetada	bofet�o
bofetear	estapear
bofet�o	munheca�o
boiante	flutuador
boiar	patetar
bojamento	bojo
bojar	crescer
bolacha	pitomba
bolar	engenhar
bolboso	bulb�ceo
boldri�	talim
bolear	esmerilar
boleta	penduricalho
bolhar	borbulhar
bol�ar	regurgitar
bom	competente
bombinha	traque
bomb�stico	grand�loquo
bonacheiro	bonanch�o
bonacheir�o	bonacheiro
bonan�a	sossego
bondadoso	bondoseiro
bongar	vigilar
bonificar	laurear
bonitete	bonitote
bonito	elevado
boquear	vasquear
boquejadura	cochicho
boquejar	difamar
boquiaberto	pasmado
borboleteador	borboleteante
borbot�o	borbulh�o
bordar	broslar
bordejar	nutar
bordoada	ma�ada
bord�o	cacete
borraceiro	borri�o
borracheira	embriagamento
borradela	n�doa
borrar	ensaburrar
borrar-se	emporcar-se
borra�al	tramolhada
borrifar	serenar
borri�ar	pingotear
borri�o	molinheiro
botar	embotar
botar-se	desembestar-se
boto	cego
botocudo	r�stico
boucera	tomento
boxe	pugilismo
bo�al	rude
bradar	esgoelar
bradejar	uivar
bramar	toar
bramir	explodir
bramoso	furioso
branco	l�cteo
brandear	desencruar
brando	fagueiro
brandura	macieza
brand�o	tocha
branqueado	caleado
branquear	embranquecer
branquejar-se	encanecer-se
bravatear	fumacear
bravejar	ulular
braveza	fereza
bravio	encapelado
bravo	poisio
bravura	resolu��o
brecar	domar
brejeirice	garotice
brejeiro	tunante
brejo	sapal
brejoso	charqueiro
breve	sin�tico
breviloq�ente	sintetizado
briga	turbul�ncia
brigante	conflituoso
briguento	rusguento
brig�o	briguento
brilhante	fastoso
brilhantismo	majestade
brilhar	sobressair
brilho	luzimento
brincadeira	goza��o
brincado	engalenado
brincalh�o	engra�ado
brincar	divertir-se
brinde	voto
brio	potra
brioso	destemeroso
britar	migar
brocar	lurar
bromar	corroer
bronco	calino
bronquear	trautear
brotadura	gomo
brotamento	renovo
brotar	propagar
brumaceiro	nevoento
brumado	brumoso
brunhir	polimentar
brunido	reluzente
brunir	polimentar
bruno	escuro
brusco	inesperado
brutal	desumano
brutalidade	selvageria
brutalizar	exulcerar
brutalizar-se	descivilizar-se
brutalmente	brutamente
brutificar	descivilizar
brutificar-se	descivilizar-se
bruto	mazorro
bruxa	feiticeira
bruxaria	salga��o
bruxedo	macumba
bruxo	necromante
bruxulear	estrelar
bucuva	tolaz
buc�lico	campeiro
bueiro	sumidoiro
bufador	van�loquo
bufo	c�mico
buf�o	farsante
bulc�o	redemoinho
bulhento	rumoroso
bulh�o	rixador
bulir	comover
bumbar	zurzir
buracada	buraqueiro
buraco	hiato
burburinho	murmurinho
burla	fraudul�ncia
burlado	emba�do
burlador	logrativo
burlante	trapaceiro
burlar	tapear
burlaria	falsifica��o
burlequear	haraganar
burlescamente	comicamente
burlesco	c�mico
burl�o	intruj�o
burrego	burro
burricada	parvo�ce
burundanga	embrulhada
buscado	procurado
buscar	pegar-se
butuca	espora
buzinada	cornetada
bu�do	safado
b�	pajem
b�ratro	sorvedoiro
b�rbaro	violento
b�tega	cordoada
b�bado	mordido
b�bedo	tonto
b�lido	zela��o
cabalar	enredear
cabana	tijupar
cabeceira	manadeira
cabeladura	encabeladura
caber	conter
cabe�a	chefe
cabe�o	outeiro
cabe�udo	contumaz
cabido	pertinente
cabimento	prop�sito
cabisbaixo	humilhado
cabo	extremidade
caboclo	caipira
caborje	salga��o
cabortar	carapetar
cabotagem	costeio
cabou�ar	desencavar
cabriolar	piruetear
cabrocar	segar
cabrucar	ro�ar
cabrum	caprum
cabuetar	entregar
cacarecos	petrechos
cacarejar	chilrar
cacaria	caranguejola
cacar�us	caramingu�s
cacerenga	caxirenguengue
cacetada	cachamorrada
cacetear	fartar
cachaceira	zangurrina
cachaceiro	ebrioso
cachamorrada	marretada
cachar	capear
cacha�a	pinga
cacha�o	toiti�o
cacha�udo	soberbo
cachetar	ca�oar
cachimbar	esfumear
cachimbo	pito
cacho	caracol
cachorrada	cain�a
cachorrice	cafajestice
caco	entulho
cacoete	tique
cacunda	canastra
cadaveroso	mortuoso
cadeia	corrente
cadenciado	r�tmico
cadencioso	melodioso
cadimo	sagaz
cadinho	crisol
cadivo	coroca
caducidade	decrepitude
caduco	senil
caduquez	decrepidez
cafangar	galhofear
cafifice	cafifismo
cafund�-do-judas	cafund�rio
cag�etar	delatar
caiar	emascarar
cainho	esganado
caiongo	passado
caipirice	jequice
caiporice	caiporismo
caiporismo	malogro
cair	desgrudar-se
cairelar	embainhar
caixa	caixote
caixa-forte	cofre-forte
cajadada	pancada
calado	embuchado
calafetagem	calafetamento
calafetamento	veda��o
calafriento	calefriento
calar	mentir
calcadura	esmagamento
calcamento	esmagamento
calcanhar	couce
calcar	encarregar
calcinar	queimar
calcitrar	engravitar-se
calcular	medir
calda	xarope
caldear	liar
caldear-se	mesti�ar-se
calejado	catuzado
calejar-se	obdurar-se
calend�rio	cronograma
calhar	quadrar
calhorda	desprez�vel
caliginoso	obscuro
calino	rombo
calip�gico	calip�gio
calista	pedicuro
calistismo	mofina
calma	repouso
calmante	sedativo
calmar	contentar
calmar-se	desencalmar-se
calmo	calmoso
calo	tiloma
caloiro	recruta
calor	queimor
caluniar	desonestar
calvinista	presbiteriano
cal�adeira	descal�ador
cal�amento	passeio
cal�nia	mentira
camada	classe
cambalear	titubar
cambalhotar	piruetar
cambap�	gamb�rria
cambar	dar
cambembe	estavanado
cambetear	mancar
caminhador	caminhante
caminhar	ir
caminho	trilho
campaniforme	campanul�ceo
campanulado	campanular
campar	enrinconar
campear	pleitear
camp�nula	redoma
camp�nio	r�stico
canal	medianeiro
canastra	lombo
cancelamento	rescis�o
cancelar	rescindir
canceroso	carcinomatoso
cancioneiro	div�
candelabro	serpentina
candente	nitente
candongar	pajear
candongueiro	lisonjeador
canhambola	quilombola
canhestro	esquerdo
canhoneio	fuzilaria
canhoto	desjeitoso
cano	tubo
canoura	tremonha
cansar	entibiar
cansar-se	estafar-se
cansa�o	lassitude
canseira	fatigamento
cans�vel	fatig�vel
cantar	levantar
can��o	cantadela
caolho	zer�
caos	inferno
capacidade	compet�ncia
capacitado	capaz
capadura	emascula��o
capanga	pistoleiro
capangada	jagun�aria
capa��o	mutila��o
capcioso	sabido
capeado	encoberto
capear	carambolar
capela	grinalda
capelo	chapeir�o
capengante	carap�
capinador	carpidor
capinar	ro�ar
capiongo	juruju
capital	mortal
capitalizar	poupar
capitoso	opini�tico
capitular	conceituar
captar	produzir
capucho	insoci�vel
capuz	chapeir�o
caquerejar	palrear
cara	queixo
caracolear	volutear
caracterizar	descobrir
caracterizar-se	especializar-se
caracter�stica	particularidade
caracter�stico	genu�no
carambolar	engabelar
caramboleiro	cuvilheiro
caramunhar	chorincar
caranguejar	embasbacar
caranguejola	casca-de-noz
caraolho	olhizaino
carapu�a	gorro
carap�	penc�
caraterizar	desencobrir
carater�stica	singularidade
caravana	tropa
carcarejar	matraquear
carcerar	prear
carcomer	devorar
cardinal	principal
cardinalesco	cardinal�cio
carecer	padecer
careta	visagem
careteiro	mogangueiro
carga	opress�o
caricato	c�mico
cariciar	cortejar
caricioso	carinhoso
carici�vel	suave
caridoso	caritativo
carimbar	divisar
carinho	vigil�ncia
carinhosamente	meigamente
carinhoso	doce
carism�tico	epil�ptico
cariz	celagem
carmim	carminado
carminar	esfoguear
carnalidade	mundanalidade
carnavalear	doudejar
carnear	siderar
carneiro	ossu�rio
carniceiro	magarefe
carnificina	matan�a
caro	precioso
carolo	coque
caroneado	deluso
caronear	desvairar
caro�vel	prazenteiro
carpetar	entapizar
carpidor	mondador
carpir-se	lamuriar-se
carquilha	ruche
carrancudo	sobrancelhudo
carrapatar-se	grudar-se
carrascoso	carrasquento
carrear	transportar
carregado	intenso
carregar	prostrar
carreira	trilha
carreirismo	oportunismo
carro	ve�culo
carruagem	dilig�ncia
carta	diploma
cartada	lan�o
carteamento	correspond�ncia
carteira	escrivaninha
cart�rio	tabelinado
car�ter	qualidade
car�o	tosa
car�ncia	m�ngua
car�cia	quitute
casa	resid�ncia
casaco	palet�
casar-se	unir-se
casca	c�dea
cascar	descorticar
cascavel	chocalho
cascorriento	perebento
caseiro	humildoso
casmurro	encaramujado
caso	epis�dio
casquilhar-se	encasquilhar-se
casquilho	puxadinho
casquinada	motejo
casquinha	plaqu�
cassar	resilir
casta	linhagem
castamente	inocentemente
castear	reproduzir-se
castica��o	importuna��o
castidade	contin�ncia
castigar	ensinar
castigar-se	penitenciar-se
castigo	reprimenda
casti�ar-se	copular-se
casto	ing�nuo
castrar	mutilar
casual	imprevisto
casualidade	esporadicidade
catadupa	salto
catar	seletar
catarata	salto
categoria	posi��o
categoricamente	expressamente
catingudo	caxinguento
cativante	sedutor
cativar	confinar
cativar-se	subjugar-se
catraca	roleta
caturrar	encasquetar-se
cat�logo	elenco
causa	partido
causticar	narcotizar
cautela	circunspe��o
cauteloso	providente
cauterizar	confranger
cau��o	fian�a
cau�la	tacanho
cau�ra	mesquinho
cavacos	sarandalhas
cavador	furador
cavalari�a	persigal
cavalgar	cavaloar
cavalheiresco	gentil
cavalheirismo	galanice
cavaquista	irrit�vel
caveira	cr�nio
cavilhar	tarugar
cavoucar	escavar
caxinguento	fedegoso
caxiri	veneno
ca�a	persegui��o
ca�ambeiro	lisonjeador
ca�oada	trote
ca�oador	sarc�stico
ca�oante	zombador
ca�oar	satirizar
ca�do	gelado
ceder	diminuir
cedi�o	prosaico
cegante	deslumbroso
cegar	embaciar
cegar-se	lograr-se
cegueira	fanatismo
ceifar	fou�ar
celebrar	exal�ar
celebridade	fama
celebriza��o	imortaliza��o
celeste	celestial
celsitude	excelsitude
cena	espet�culo
cenagoso	obsceno
cenosidade	impureza
cenoso	forte
cenrada	lix�via
cension�rio	censit�rio
censual	censu�rio
censura	raspanete
censurado	reprovado
censurar	estranhar
centelha	fa�sca
centelhar	vagalumear
cen�rio	cenat�rio
cercar	toucar
cercear	estreitar
cerco	cinto
cerebral	mental
cerimonioso	mesurado
cerim�nia	requifife
cerrado	unido
cerrar	juntar
cerrar-se	encangotar-se
cerro	outeiro
certame	justa
certar	debater
certeza	segureza
cert�men	justa
cerzir	intervalar
cessar	terminar
cesto	patigu�
cesura	corte
cevado	gordo
cevo	engorda
chacota	remoque
chacotear	zombar
chafurda	enxurdeiro
chafurdar	enlodar
chafurdeiro	porqueira
chafurdice	sord�cie
chalacear	vasconcear
chala�ar	pagodear
chaleirar	lisonjear
chaleirice	chaleirismo
chalrador	gralhador
chamada	liga��o
chamado	convocat�ria
chamamento	rebate
chamar-se	qualificar-se
chamboado	mal-apresentado
chamego	galanteio
chamejamento	chamejo
chamejar	esplendecer
chamuscada	chamusco
chamuscadura	sapeca
chamuscar	crestar
chance	deixa
chancelar	timbrar
chanfradura	entalhadura
chanfro	talha
chapa	tabla
chapar-se	estirar-se
charlar	tartarear
charlariento	palavreador
charro	grosseiro
charruar	navegar
charutaria	tabacaria
chasqueador	ludibrioso
chasquear	pantear
chatear	destro�ar
chatea��o	importuna��o
chateza	estopada
chatinar	subornar
chato	liso
chavascada	preacada
chavascal	cortelha
chavasco	grosseiro
chavasqueiro	r�stico
chavasquice	impolidez
chavear	fechar
checagem	verifica��o
checar	reverificar
chefiar	patroar
chegada	tornada
chegadi�o	metido
chegado	�ntimo
chegar	vingar
chegar-se	conformar-se
cheia	unda��o
cheio	completo
cheirante	odoroso
cheirar	intuir
cheiro	rabeira
cheiroso	olorado
chiar	ferretoar
chibante	jactancioso
chibatada	verdascada
chibatar	vapular
chibatear	vergalhar
chicanista	rabulejador
chicle	chiclete
chicotada	ripada
chicotar	surrar
chicote	relho
chicotear	lambar
chilique	fricote
chilrar	pipilar
chilreador	chilreiro
chilreante	golelheiro
chilrear	estribilhar
chilreiro	dizedor
chilro	trinado
chimarra	samarra
chispar	indignar-se
chistoso	gracioso
chocalheiro	intrigante
chocar-se	embater-se
chocarrear	rir
chocho	pac�vio
choco	dissaboroso
chofer	motorista
choque	encontroada
choradeira	gemido
chorado	pranteado
choramigador	choramingador
choramigueiro	choramingueiro
choramingo	lacrimejamento
choraminguento	chor�o
chorar	ulular
choroso	sentido
chorrar	golfar
chorrilho	mont�o
chorro	jorro
chorumela	frioleira
cho�a	mocambo
chuchar	sorver
chulice	grosseria
chumbar	ligar
chupa-sangue	parasito
chupar	libar
churdo	ludroso
chutar	enjeitar
chuvarada	cordoada
ch�	plan�cie
ch�o	manso
cicatrizar	sarar
ciciar	cochichar
cicioso	sussurrejante
cientificar	comunicar
cientificar-se	noticiar-se
cifra	enigma
cifrar	epitomar
cilada	esparrela
cilindroforme	cilindr�ide
cilindr�ide	teretiforme
cimentar-se	firmar-se
cimo	cocoruto
cim�lio	raridade
cim�rio	lutuoso
cinca	cincada
cincada	erro
cindir	desentrosar
cineral	cinzeiro
cinera��o	incinera��o
ciner�cio	cinza
cingir	coagir
cingir-se	limitar-se
cinocef�lico	cinoc�falo
cinta	precinto
cintilante	fulguroso
cintilar	fulgurar
cinza	rescaldo
cinzado	cinzento
cinzelar	gravar
cin�reo	cinzado
cirandinha	roda
circo	c�rculo
circotel�rico	circoterrestre
circuitar	envolver
circuito	periferia
circular	mexer-se
circula��o	gira��o
circundamento	rodeamento
circundar	perlongar
circunfer�ncia	contorno
circunsoante	circunsonante
circunspec��o	tino
circunspetamente	gravemente
circunspeto	recatado
circunspe��o	prud�ncia
circunstanciar	pormenorizar
cirro	estertor
ciscalhagem	cisqueiro
cisma	imagina��o
cismado	difidente
cismar	suspeitar
cismarento	penseroso
cismativo	imaginativo
cism�tico	cogitabundo
cis�o	corte
ciumada	ciumaria
ciumento	zeloso
ciumoso	invejoso
civilidade	trato
clamador	gritador
clamar	requisitar
clamor	vindica��o
clandestinidade	ilegitimidade
clangor	ribombo
claramente	obviamente
clarear	diminuir
clarea��o	dilucidamento
clarificar	emundar
claro	morto
clar�o	fulgor
classificar	p�r
claudicante	tr�mulo
clausurar	entaipar
clava	toco
clem�ncia	indulg�ncia
climat�rio	clim�tico
clitor�deo	clitoridiano
cl�rigo	eclesi�stico
cl�nico	terapeuta
coacervado	encastelado
coacto	invito
coador	filtro
coadunar	convir
coadunar-se	congregar-se
coagido	invito
coagir	reduzir
coalescer	juntar
coalhado	repleto
coalhar	solidar
coalizar-se	consorciar-se
coaliz�o	coliga��o
coar	destilar
coarctador	coartador
coarcta��o	estreitamento
coarcto	coarto
coatar	reprimir
coato	contrafeito
coa��o	press�o
cobardia	covardia
coberta	ensombro
cobertura	tapa��o
cobi�ado	desejado
cobi�oso	sequioso
cobrador	recebedor
cobrar	refocilar
cobrimento	tapadura
cobrir	satisfazer
cobrir-se	turvejar-se
coceira	uredo
cochicho	rumor
codificar	coligir
codilhar	emba�ar
codizar	criptografar
coer��o	press�o
coer�ncia	nexo
cogitabundo	cogitativo
cogitar	ponderar
cognado	cognato
cognominador	denominador
coibir	frear
coibir-se	mesurar-se
coincidir	haver
coirela	courela
coiro	couro
colaborar	entrar
colabora��o	conspira��o
colar	emendar
coleante	serpenteante
colecionar	reunir
coleta	colhimento
coletor	receptor
cole��o	compila��o
colheita	safra
colher	lograr
colidente	desencontrado
colidir	percutir
coligado	confederado
coligar-se	ligar-se
coligidor	compilador
coligir	extrair
colimar	mirar
colina	morro
colis�o	dissid�ncia
colocar	propor
colocar-se	p�r-se
coloca��o	ordenamento
coloidal	col�ide
colorante	corante
colorar	envolver
colorar-se	rosar-se
colorear	sazonar
colorir	encangotar
colorir-se	rubescer-se
colorizar	decorar
colossalidade	enormidade
colubrejar	serpear
columbino	virgem
coluna	pilar
col�rico	sanhudo
col�nia	protetorado
comandar	conduzir
comando	r�dea
combalido	dessangrado
combalir	estremecer
combate	torneio
combatente	militar
combater	punir
combinado	determinado
combinar	consonar
combinar-se	concertar-se
comburir	incinerar
combustar	inflamar
combust�o	ignifica��o
comedimento	compostura
comedir	sopitar
comemorar	revisitar
comemora��o	festejo
comensurar	igualar
comenta��o	coment�rio
comer	nutrir-se
comer-se	dilacerar-se
comercializa��o	extra��o
cometer	interprender
comezinho	humilde
come�ado	iniciado
come�o	limiar
comida	repasto
comido	nutrido
cominuir	moer
comiserar-se	condoer-se
comissionar	recomendar
comodidade	confortabilidade
comovente	enternecedor
comover	desencruar
comover-se	desarmar-se
compactar	compendiar
compacto	maci�o
compadecer	suportar
compadecer-se	condoer-se
compadresco	compadrio
compaix�o	miseric�rdia
companhia	cortejo
comparar	opor
compara��o	confronto
comparecimento	presen�a
comparte	s�cio
compar�vel	parecente
compassar	ritmar
compassividade	condol�ncia
compatibilidade	equival�ncia
compatibilizar	reunir
compelir	obrigar
compendioso	resumido
compensar	pagar
comperto	descoberto
competente	gabaritado
competidor	contendor
competitividade	rivalidade
competi��o	concurso
compet�ncia	distrito
compilar	reunir
complementar	trancar
completar	fazer
completo	ultimado
complexidade	pluralidade
complexo	implexo
complicado	enredado
complicar	enlear
complicar-se	embretar-se
complica��o	embara�o
compl�	trama
componente	ingrediente
compor	unir
comportar	permitir
comport�vel	concili�vel
comprazer	releixar
comprazer-se	regozijar-se
compreender-se	perceber-se
compreendido	percebido
compreens�o	depreens�o
comprido	longo
comprimir	retrair
comprimir-se	contorcer-se
comproba��o	confirma��o
comprometer	compromissar
comprometimento	prometimento
compromissar	meter
compromisso	obriga��o
compuls�o	empurra��o
compungido	pesaroso
compungir	entristecer
compungir-se	enternecer-se
comum	corriqueiro
comumente	vulgarmente
comunh�o	uni�o
comunicabilidade	comunicatividade
comunicar-se	contatar
comunicativo	expansivo
comunica��o	di�logo
comunidade	irmandade
comun�ssimo	vulgar�ssimo
comutar	escambar
comuta��o	volta
conato	insito
conatural	nato
concatenado	engranzado
conceber	meditar
conceder	votar
conceitar	tachar
conceito	opini�o
conceitua��o	defini��o
concentrar-se	conglomerar-se
concept�vel	percept�vel
concep��o	formula��o
concernente	respeitante
concernir	convir
concern�ncia	pertin�ncia
concertar	consonar
concertar-se	dar-se
conchavar-se	mancomunar-se
conchavo	mancomunagem
conchegar-se	unir-se
conciliar	enla�ar
conciliar-se	engra�ar-se
concilia��o	reconcilia��o
concili�bulo	conspirata
concionar	discursar
conciso	condensado
concitar	reprurir
concita��o	incitamento
concludente	terminativo
concluir	deduzir
conclusivo	dedutivo
conclus�o	conseq��ncia
conclu�do	encerrado
concordar	tratar
concorrente	oponente
concretizar	efeituar
concreto	definido
conculcado	humilhado
conculcar	depreciar
concupisc�ncia	sensualismo
concurso	coopera��o
concutir	encasquetar
conc�rdia	confraterniza��o
conc�bito	c�pula
condecora��o	honraria
condenar	desadorar
condena��o	senten�a
condensante	condensativo
condescender	transigir
condessar	meter
condimenta��o	tempero
condizer	harmonizar
condi��o	condicional
condoreiro	rebuscado
conduzir	vibrar
conectivo	copulativo
confabular	falar
confec��o	preparo
confeitaria	doceria
conferir	reverificar
confer�ncia	conversa��o
confessar	revelar
confessar-se	reconhecer-se
confessor	cura
confiabilidade	fiabilidade
confiado	desenvergonhado
confiar	encargar
confim	fronteiro
confinante	cont�rmino
confinar	determinar
confirmador	confirmativo
confirmar	verificar
confirmativo	corroborativo
confiss�o	desabafo
conflagrar	eletrizar
conflagra��o	revolta
conflito	embate
conformar	harmonizar
confortador	confortante
confortar	fortificar
confranger	morder
confrangido	torturado
confraternar	fraternizar
confrontar	encontrar
confrontar-se	encarar-se
confronta��o	contraposi��o
confundir-se	intermisturar-se
confuso	esf�ngico
confus�o	tumulto
confutar	impugnar
confuta��o	obje��o
congelamento	resfriamento
congelar	regelar
congeminar	redobrar
congeneridade	semelhan�a
congestionar	entupir
conglobar	reunir
conglobar-se	congregar-se
congloba��o	conglomera��o
conglomerar-se	somar-se
conglutinar	congregar
conglutinoso	pegajento
congra�ar-se	harmonizar-se
congregar	ligar
cong�nere	parecido
cong�nito	nativo
conhecedor	s�bio
conhecer	reconhecer
conhecimento	escola
conjectural	hipot�tico
conjecturar	surpresar
conjeturar	esmar
conjuga��o	jun��o
conjurar	impetrar
conjurar-se	rebelar-se
conquistar	tomar
consagrar	sacramentar
consagrar-se	dedicar-se
consecutivamente	sucessivamente
conseguir	ter
conselho	recado
consentir	sofrer
conseq��ncia	fruto
consertado	reformado
consertar	medir
conserto	refazimento
conservar-se	vir
conservativo	conservat�rio
conserva��o	salvaguarda
considerar	encarar
considerar-se	pretender-se
considera��o	defer�ncia
consider�vel	not�vel
consignar	firmar
consistente	pastoso
consistir	repousar
consociar	reconciliar
consociar-se	reunir-se
consolador	solaz
consola��o	consolo
consolidar	estipular
consolidar-se	louvar-se
consolida��o	corporifica��o
consonante	c�nsono
consorciar-se	desposar
consorcia��o	cons�rcio
conspicuidade	notabilidade
conspirar	lambancear
conspira��o	conspirata
conspurcar	manchar
conspurca��o	estrago
constante	freq�ente
consternado	desolado
consternar-se	horrorizar-se
consterna��o	pesadume
constituir	deixar
constranger	oprimir
construir	criar
constru��o	edif�cio
const�ncia	insist�ncia
consulta	pesquisa
consumar	efetivar
consuma��o	realiza��o
consumido	consunto
consumir	dissipar
consumir-se	ir
consumo	sumpto
consunto	gasto
cons�cio	parceiro
conta-giros	taqu�metro
contactar	tocar-se
contaminar	infeccionar
contaminar-se	infeccionar-se
contamina��o	estrago
contar	dizer
contatar	tocar-se
contato	conv�vio
contemplar	refletir
contemplar-se	ver-se
contemporizar	repoisar
contempt�vel	ignominioso
contenda	renhimento
contendedor	emulador
contendente	inimigo
contender	triscar
contentar	repousar
conten��o	encerramento
conter	reportar
conter-se	subjugar-se
contestabilidade	repreensibilidade
contestar	contrariar
contesta��o	nega��o
contexto	tese
contextura	tra�a
contido	sofreado
continente	parcimonioso
contingente	transit�rio
continuado	ininterrupto
continuar	esticar
continua��o	decurso
conto	dito
contorcer	quebrar
contornar	quebrar
contorno	volta
contor��o	tor�o
contra-arrazoado	r�plica
contra-arrestar	empacar
contra-atacar	responder
contrabando	muamba
contract�vel	contr�til
contraditado	desdito
contraditar	opugnar
contradito	desmentido
contradit�rio	paradoxal
contrafazer	sobnegar
contrafazer-se	sofisticar-se
contrafeito	violentado
contrair	murchar
contrapeso	sobrepeso
contrapontear	repostar
contrapor	voltar
contrariar	desgostar
contrariedade	oposi��o
contrari�vel	controvert�vel
contrastar	opor
contrastear	esmar
contratante	empregador
contratar	firmar
contrato	tratado
contraverter	so�obrar
contravir	desobedecer
contra�do	franzido
contribui��o	encargo
contristado	pesaroso
contrista��o	melancolia
controverter	questionar
controvert�vel	disput�vel
contr�rio	desavindo
contumaz	persistente
contumelioso	ofensivo
contum�lia	insulto
contundido	pisado
conturbado	revoltado
conturbar	desacomodar
contus�o	les�o
cont�rrito	surpreso
cont�guo	prop�nquo
cont�nuo	freq�ente
conubial	marital
convalescen�a	restaura��o
convalescer	reverdecer
convencedor	suas�rio
convencer	encasquetar
convencionar	estabelecer
conveniente	pertinente
converg�ncia	influxo
convers�o	transmuda��o
converter	transubstanciar
converter-se	imutar-se
convidativo	tentador
convincente	eloq�ente
convir	dar-se
conviv�ncia	conv�vio
convizinho	parecido
convulsionar	rebelar
copado	frondente
copiar	tirar
copiosidade	excessividade
copioso	opulento
copo	ta�a
coragem	valor
corajudo	foito
corar	erubescer
corar-se	encafifar-se
corcovar-se	envergar-se
corcovo	pinote
cordagem	cordoalha
cordato	sensato
cordial	fagueiro
cordoada	salseirada
cord�o	s�rie
coriscar	relampear
cornadura	haste
coroar	eleger
corogr�fico	ctonogr�fico
corporalizar	materializar
corporatura	vulto
corporificar-se	incorporar-se
corpulento	obeso
corpul�ncia	espessura
corredio	macio
correia	loro
corrente	veia
correntio	costumeiro
correr	enxotar
correr-se	pejar-se
corresponder	satisfazer
correto	probo
corretor	intercessor
corretora	terceira
corre��o	pena
corrido	exclu�do
corrigenda	prega��o
corrigir	ordenar
corrimaca	por��o
corrimento	escoamento
corroborar	demonstrar
corroer	erosar
corromper	malignar
corromper-se	putrefazer-se
corrompido	corruptivo
corrompimento	podriqueira
corros�o	desgaste
corro�do	desgastado
corrugado	engelhado
corrugar	encoscorar
corrugar-se	encorrilhar-se
corrupiar	rodopiar
corruptibilidade	impiedade
corruptivo	corrupto
corrupto	ruim
corrupt�vel	corruto
corrup��o	deprava��o
corruto	vicioso
cortante	lacerante
cortar	obstruir
corte	quebra
cortejar	sorrabar
cortesia	delicadeza
cortes�o	esbelto
cort�s	educado
coruch�u	p�ncaro
coruscante	faiscante
coruscar	lustrar
corusca��o	rel�mpago
corvejar	grasnar
coscoro	crusta
coscuvilhar	onzenar
coscuvilheiro	enredeiro
costa	encosta
costume	uso
costumeiro	usual
costum�rio	freq�ente
cota	cota-parte
cotidianidade	unisson�ncia
cotiza��o	rasca
cotovelar	esfoguear
coudelaria	haras
couteiro	montaraz
cova	furna
covarde	pusil�nime
coveiro	enterrador
co�ar	surrar
co�ar-se	esfregar-se
cravado	fixo
cravar	embutir
cravejar	embutir
credo	cren�a
crena	fissura
crendeiro	simpl�rio
cren�a	f�
crepitar	estralar
crer	pressupor
crescendo	grada��o
crescer	progredir
crescido	fermentado
crespir	salpicar
crespo	encapelado
crestar-se	tostar-se
cretinice	zotismo
cretino	nenho
criado	servente
crian�a	pequeno
crian�ada	molecada
crian�ola	dunguinha
criar	fornecer
criatividade	inventiva
criatura	pessoa
cria��o	idea��o
criptograma	enigma
crise	tens�o
crisolar	desbastecer
crispar-se	embabadar-se
crispatura	franzimento
crispa��o	franzimento
criterioso	ponderado
criticar	funestar
critic�vel	culp�vel
crit�rio	roteiro
crocitar	gralhar
cru	feroz
crucial	prec�puo
cruciar	remoer
crucificar	moer
cruel	maldito
cruento	sevo
cruz	madeiro
cruzar	passar
cruzar-se	entrecruzar-se
cr�dito	nome
cr�tico	dif�cil
cr�nico	enraizado
cuca	jabiraca
cuia	porongo
cuidadeiro	diligente
cuidado	provimento
cuidadoso	cuidoso
cuidar	imaginar
cuidar-se	resguardar-se
cuidoso	vigilante
cuit�	porongo
culmina��o	culmin�ncia
culmin�ncia	c�mulo
cultivado	culto
cultivo	cultura
culto	policiado
cumprimenteiro	mesurado
cumprir	interessar
cumprir-se	dar-se
cumular	encastelar
cumula��o	superposi��o
cunhar	monetizar
cupom	t�quete
curar	ocupar-se
curral	est�bulo
curteza	tacanhez
curtir	expiar
curto	r�pido
curva	sinuosidade
curvado	curvo
curvar-se	envergar-se
curvatura	dobra
curvetar	espinotar
curvo	inflecto
cusparada	cuspinhada
cuspidela	cuspinhada
cuspidor	escarradeira
custoso	duro
cuvilheiro	mexeriqueiro
czar	tzar
c�ften	rufi�o
c�lculo	computa��o
c�lido	calmo
c�mbio	troca
c�ndido	melindroso
c�ntaro	talha
c�rceo	rente
c�tico	descrente
c�nico	impudico
c�rculo	roda
c�dex	c�dice
c�dice	pugilar
c�lera	c�lera-morbo
c�pia	traslado
c�modo	tranq�ilo
c�mpar	conforme
c�mputo	tento
c�ncavo	fundo
c�mplice	s�cio
c�pido	sequioso
dactilino	datilino
dactiliol�gico	datiliol�gico
dadivoso	generoso
dado	tendente
dama	dona
damejar	requestar
danado	exasperado
danar	empe�onhentar
danar-se	espinhar-se
dana��o	estrago
dandinoso	janota
danificar	daninhar
danificar-se	inutilizar-se
daninhar	desmelhorar
dan�ar	sapatear
dar	engendrar
dar-se	ocasionar-se
dardada	lancetada
dardejar	relampadear
dealbar	purgar
dealvar	lavar
deambula��o	passeio
deaurar	doirar
debandar	estro�ar
debandar-se	desbandalhar-se
debater	gladiar
debater-se	estrebuchar-se
debelar	for�ar
debicar	sotaquear
debilidade	senilidade
debilitado	prostrado
debilitar	enfraquecer
debique	manga��o
debochado	licencioso
debochador	zombador
debochar	tro�ar
debochar-se	desvirtuar-se
deboche	desregramento
debotar	deslavar
debru�ar	desaprumar
debru�ar-se	enconchar-se
debulha	defraudamento
debulhado	escorchado
debulhar	escarolar
debutar	iniciar-se
decad�ncia	derrocada
decaimento	degeneresc�ncia
decair	reclinar
decantar	refinar
deca�da	decaimento
decente	�ntegro
decepado	seccionado
decepamento	estroncamento
decepar	estropiar
decepcionar	desencantar
decep��o	desengano
decesso	perda
decididamente	resolutamente
decifrar	decriptar
decifra��o	decripta��o
decis�o	determina��o
declamar	reclamar
declamat�rio	guindado
declama��o	recital
declarado	ostensivo
declarador	declarante
declarar	escolher
declarar-se	reconhecer-se
declara��o	documento
declinar	sair
declina��o	decl�nio
declivado	escarpado
declive	pendor
declivoso	teso
decolorar	descorar
decompor	putrificar
decorar	honestar
decoroso	reto
decorrido	transato
decorr�ncia	decurso
decortica��o	descascamento
decote	degolo
decremento	decrescimento
decretar	impor
decriptar	descodificar
decr�pito	desca�do
decuri�o	monitor
decurso	volvido
dedicar	devotar
dedurar	revelar
deduzir	inferir
dedu��o	depreens�o
defecar	obrar
defectivo	defeituoso
defeito	v�cio
defender	vetar
defensor	padroeiro
defensora	tutora
defens�o	resguardo
defesa	discurso
definido	divisado
definito	preciso
deflegmador	desflegmador
deflex�o	deslocamento
deflora��o	desvirginamento
defl�vio	deflux�o
deformar	desfigurar
deforme	monstruoso
deformidade	pervers�o
defraudar	gatunhar
defumadoiro	defumador
defumar	perfumar
defumar-se	enfrascar-se
degastador	estr�ina
degelar	desgelar
degenerar	derrancar
degenerar-se	estragar-se
degenera��o	podrid�o
degolar	jugular
degradador	deprimente
degradar	desonrar
degradar-se	desautorar-se
degrada��o	lama
degusta��o	prova
deitar	p�r
deitar-se	reclinar-se
deixa	oportunidade
deixar	respeitar
dejejua	dejejuadouro
dejungir	engaiolar
delapidar	entornar
delatar	patentizar
delator	malsim
delegado	enviado
delega��o	representa��o
deleitar	refocilar
deleitar-se	satisfazer-se
deleita��o	prazer
deleite	prazimento
delet�rio	pernicioso
delgadeza	magrez
delgado	delicado
delga�ar	empalidecer
delibar	libar
deliberado	resoluto
delicadeza	primor
delicado	suave
deliciar	lisonjear
deliciar-se	gozar-se
deliciosamente	saborosamente
delicioso	saboroso
delimita��o	limita��o
delineamento	esqueleto
delinear	esbo�ar
deliquio	desacordo
delir	fundir
delirado	tresloucado
delirante	insano
delirar	doudejar
delito	irregularidade
delombar	dominar
delonga	prorroga��o
delongar	diferir
delongar-se	prolongar-se
delucidar	instruir
deludir	tapear
deluso	engalhopado
delus�rio	quim�rico
del�rio	desatino
demais	intensamente
demanda	discuss�o
demandar	espreitar
demasia	desmedida
demasiado	superv�cuo
demasiar-se	exorbitar
dementado	insano
demente	louco
demineralizar	desmineralizar
demitir	despachar
demolido	derru�do
demolidor	destruidor
demolir	rebaixar
demonetizar	envilecer
demonioman�aco	demonopata
demonstrar	reproduzir
demonstra��o	prova
demon�aco	diab�lico
demora	retardamento
demorar	habitar
demorar-se	retardar-se
demover	despersuadir
demudar	mudar
demudar-se	transmudar-se
dem�o	retoque
denegrecer	deslustrar
denegrido	enegrecido
denegrir-se	entrevecer-se
denodado	desmedroso
denodo	desembara�o
denominar	tachar
denotar	expressar
denota��o	manifesta��o
dentado	mordido
dentar	dentear
denudado	desnu
denudar	despir
denuda��o	desmascaramento
denunciador	denunciante
denunciante	malsim
denunciar	revelar
denunciar-se	descobrir-se
deparar	desencobrir
depauper-se	exaustar-se
depauperado	empobrecido
depaupera��o	empobrecimento
dependente	submetido
depender	originar-se
dependura	pendura
dependurar-se	suspender-se
depilar	rapar
deplorativo	lacrimante
deplor�vel	ominoso
depor	largar
deportado	�xule
deporta��o	expuls�o
depositar	enceleirar
deposi��o	destroniza��o
depravado	ruim
depravador	perversor
depravar	sofisticar
depravar-se	enchafurdar
deprecar	implorar
depreciar	desfavorecer
depreciar-se	desmerecer-se
deprecia��o	maledic�ncia
depredar	nivelar
depreender	penetrar
deprimente	humilhante
deprimir	enervar
depurador	mundificante
depurar	purificar
dep�sito	represa
derivar	jorrar
derraigado	desarraigado
derrama	derrame
derramar	partir
derrame	trasbordamento
derrancado	desgarrado
derrancar	putrefazer
derrapante	escorregadi�o
derrapar	patinar
derreado	esquadrilhado
derrear	desprezar
derreigar	desraigar
derrengar	esquadrilhar
derrengar-se	esbamboar-se
derrengue	rebolado
derretedura	liq�idifica��o
derreter	desvaecer
derreter-se	suavizar-se
derretimento	liq�efa��o
derribamento	esbarrocamento
derribar	desentronizar
derriscar	tirar
derri�ar	facetear
derri�o	namorado
derrocada	derruimento
derrocamento	derrubamento
derrocar	desfabricar
derrogar	revogar
derrota	desbarate
derrotado	vencido
derrotar	sobrepujar
derrubada	devasta��o
derrubamento	prostra��o
derrubar	desmontar
derruimento	desmoronamento
derruir	desmontar
derru�do	desmantelado
desabafar	favorecer
desabar	implodir
desabilidade	inabilidade
desabituado	desvezado
desabituar	desacostumar
desabotinado	estoirado
desabotoar	entreabrir
desabridamente	rudemente
desabrido	desamor�vel
desabrigo	desagasalho
desabrochado	desajustado
desabrochar	entreabrir
desabrolhar	desbrochar
desabusado	desfa�atoso
desabusar	desiludir
desacanhar	desencabular
desacatar	descumprir
desacato	desvenera��o
desacautelado	imprevidente
desacautelar	desguardar
desacautelar-se	desprecatar-se
desacerto	mal-entendido
desachegar-se	separar-se
desacobardar	esfor�ar
desacomodar	dessossegar
desaconchegar	vastar
desaconselhar	despersuadir
desacordante	desconcordante
desacorde	dissonoro
desacordo	discrep�ncia
desacoro�oado	desmoralizado
desacoro�oador	desconfortador
desacor�oado	desencorajado
desacor�oador	desacoro�oador
desacostumado	desvezado
desacreditar	detratar
desacreditar-se	difamar-se
desacumular	queimar
desadmoestar	desaferrar
desadorado	renegado
desadorar	intoxicar
desadora��o	execra��o
desadormentar	despertar
desafabilidade	malcriadez
desafaimar	embuchar
desafamar	setear
desafeito	desvezado
desaferrar	soltar
desaferrar-se	soltar-se
desafetado	lhano
desafeto	infenso
desafiar	peguinhar
desafinado	discorde
desafogar-se	expandir-se
desaforo	prot�rvia
desafortunado	infortunado
desafronta	desopress�o
desafrontado	desforrado
desafrontar	desapertar
desagaloar	macular
desagasalhar-se	descobrir-se
desagasalho	desamparo
desagastar	desassanhar
desaglomerar	desocupar
desagoniar	desapertar
desagravar	desinchar
desagravo	melhora
desagregar	desraigar
desagrega��o	desmembramento
desaguadoiro	sangrador
desaguar	esvaziar
desaguar-se	verter-se
desajeitado	inhenho
desajeitar-se	perturbar-se
desajoujar-se	desligar-se
desajudado	desamparado
desajuizar	descerebrar
desajuntar	desajustar
desajustado	solto
desajustar	despegar
desajustar-se	desavir-se
desalagar	desencalhar
desalentador	desanimador
desalentar	desanimar
desalento	desanima��o
desalforjar	infundir
desaliar	desunir
desalinhado	mal-amanhado
desalinhar	desaparelhar
desalinho	descuido
desalmado	desamorado
desalmo	violento
desamabilidade	impolidez
desamarrar-se	desunir-se
desamarrotar	desenxovalhar
desambicioso	desapegado
desamor	quietismo
desamorado	sanguinolento
desamor�vel	severo
desamotinar	serenar
desamparado	retirado
desamparo	solid�o
desam�vel	grosseiro
desancar	malhar
desandar	tresandar
desanelar	desencanudar
desanimado	desmoralizado
desanimador	desconsolador
desanimar	torpecer
desanojar-se	desenfastiar-se
desanuviado	escampo
desanuviar	desembruscar
desaparecer	meter-se
desaparecer-se	perder-se
desaparelhar	enfear
desapari��o	sumi��o
desapear	destruir
desapego	despego
desapertar	libertar
desapertar-se	soltar-se
desapoderar	excluir
desapossamento	despimento
desapreciar	desmerecer
desapre�ar	desapreciar
desapropositado	inoportuno
desaprop�sito	incoer�ncia
desaprovar	reprovar
desaproveitar	economizar
desaquecer	refecer
desarar	descompor
desarborizar	desmoutar
desarmado	desmontado
desarmar	desconjuntar
desarmar-se	sensibilizar-se
desarmonioso	malsoante
desarmonizar	dissentir
desarraigamento	extirpa��o
desarraigar	varrer
desarraigar-se	extirpar-se
desarranjado	descuidado
desarranjar	transverter
desarranjar-se	descompor-se
desarranjo	enxovalho
desarrazoadamente	incongruentemente
desarrazoado	ileg�timo
desarrochar	suxar
desarroupado	despido
desarrugar-se	deslisar-se
desarrumado	desorganizado
desarrumar	desestruturar
desarticular	esnocar
desarticular-se	desunir-se
desarvorado	desvariado
desarvorar	zonzar
desasar	tungar
desasseado	espurco
desassisado	malsisudo
desassisar	desjuizar
desassombrado	foito
desassossegado	estavanado
desassossego	inquieta��o
desatado	esparso
desatamento	soltura
desatar	revogar
desatar-se	romper-se
desatencioso	inam�vel
desatender	empalidecer
desatendido	indeferido
desatento	distra�do
desatinar	desencarrilar
desatracar-se	soltar-se
desatravancado	desingurgitado
desatravancamento	desimpedimento
desatremar	discrepar
desautorar	rebaixar
desautorizado	desmoralizado
desautorizar	negar
desavergonhado	petulante
desavezar	desvezar
desavir	incompatibilizar
desbancar	suplantar
desbandalhar	estrin�ar
desbandalhar-se	disparar-se
desbaratamento	esbanjamento
desbaratar	esfazer
desbarretar-se	descobrir-se
desbastado	desmoutado
desbastar	limar
desbaste	desmouta
desbastecer	madurecer
desbloquear	desentulhar
desborcelar	esborcinar
desborcinado	esbotenado
desbordar	extravasar
desbordar-se	desenfrear-se
desbotar	emortecer
desbravar	domesticar
desbrecar	desfrear
desbriado	protervo
desbriar-se	desconceituar-se
desbrochar	germinar
desbulhar	privar
desburrificar	desemburricar
descabelado	tolo
descabelar	despentear
descadeirar	rachar
descair	tombar
descama��o	escama��o
descaminhar-se	esgarrar-se
descangotado	enfraquentado
descanhotar	recalcar
descanhotar-se	desunir-se
descansado	repousado
descansar	poisar
descantar	entoar
descapacitar-se	desimaginar-se
descapelar	desencamisar
descarinhoso	severo
descarnar	emagrentar
descarregar	desquitar
descarregar-se	esvaziar-se
descarrilar	desmiolar
descarrilhado	desencarrilhado
descasado	desemparelhado
descasar-se	separar-se
descaso	displic�ncia
descautelado	imprecatado
descauteloso	desprecatado
descavar	profundar
desca�do	elanguescido
descender	ser
descend�ncia	renovo
descer	desmontar
descerebrar	despropositar
descerim�nia	irrever�ncia
descerrar	respirar
descida	queda
desclassificar	quartejar
descoagulado	descoalhado
descoberto	flagrante
descobrimento	desnudamento
descobrir	mostrar
descobrir-se	transluzir-se
descocado	impudente
descodificar	traduzir
descolorar	descorar
descolorir	desmaecer
descombinar	inimistar
descomedido	desenfreado
descomedir-se	desenfrenar-se
descometer	desculpar
descompassado	enorme
descompor	revirar
descompor-se	desorganizar-se
descompostura	zagunchada
descomunal	desmensur�vel
descomunalidade	gigantez
desconceituar-se	injuriar-se
desconcertado	embara�ado
desconcertador	desnorteador
desconcertar	desestruturar
desconchegar	destruir
desconcordante	desconcorde
desconex�o	inconex�o
desconfian�a	mesquinhez
desconforme	monstruoso
descongela��o	descongelamento
descongestionar	desinflar
desconhecedor	mal-agradecido
desconhecer	subestimar
desconhecido	mal-agradecido
desconhecimento	insipi�ncia
desconjuntar	recalcar
desconjuntar-se	inutilizar-se
desconjurar	varrer
desconsentir	destoar
desconsertar	molestar
desconsiderado	irrefletido
desconsiderar	espezinhar
desconsidera��o	irreflex�o
desconsolado	dessaboroso
descontaminar	despoluir
descontentar	desprazer
descontinuado	incont�nuo
descontinuidade	interrup��o
descontrole	desgoverno
desconvizinho	desviado
descorar	empalidecer
descoro�oado	frio
descortejar	sobpor
descortinar	perceber
descortinar-se	patentear-se
descort�s	mal-educado
descor�oado	sucumbido
descravejar	desencastoar
descreditar	exautorar
descrente	descrido
descrever	retratar
descri��o	reprodu��o
descr�dito	queda
descuidado	irreflexivo
descuidar	transcurar
descuido	despercebimento
desculpa	indulto
desculpar	ilibar
descumprir	violar
descurar	desleixar
desdenhador	menospre�ador
desdenhar	minimizar
desdenhoso	imponente
desditado	infortunado
desdizer	retratar
desdobrado	distribu�do
desdobrar-se	escangalhar-se
desdoirar	detratar
desdourar	deslustrar
desejador	desejoso
desejar	pian�ar
deselegante	indecente
desemaranhado	desembaralhado
desemaranhar	esclarecer
desembainhar	esfolhar
desembara�adamente	soltamente
desembara�ado	expedito
desembara�ar	desestorvar
desembara�ar-se	desvencilhar-se
desembara�o	intrepidez
desembebedar	desembriagar
desembebedar-se	desemborrachar-se
desembestar	remessar
desembocar	vaziar
desembocar-se	despejar-se
desembravecer	desenfezar
desembrulhar	estri�ar
desembrutecer	humanizar
desemburricar	morigerar
desembutir	desmontar
desembu�ar	respirar
desempachar	livrar
desempapar	desencharcar
desempenado	destro
desempenhar	praticar
desempossar	despojar
desempregar	dispensar
desemprenhar	desprenhar
desencalmar	desenraivecer
desencalmar-se	sossegar-se
desencaminhar	extraviar
desencaminhar-se	perverter-se
desencamisar	escamisar
desencapar	desenfardar
desencarcerado	solto
desencardir	limpar
desencarregar	desobrigar
desencarrilhar	desmandar-se
desencerrar	desvelar
desencobrir	ver
desencolerizar	desenfurecer
desencontrado	discordante
desencontrar	dissentir
desencoscorar	deslisar
desencrespar	pacificar
desenervar	vitalizar
desenfeitado	desguarnecido
desenferrujado	desentorpecido
desenferrujar-se	desoxidar-se
desenfrear-se	envinagrar-se
desenfrenar-se	espinhar-se
desenganar	despersuadir
desengatilhar	transfazer
desengenhoso	imbecil
desengrandecer	desvirtuar
desengrazar	desengrenar
desengra�ado	ins�pido
desengrenhar	emaranhar
desengrossar	detumescer
desenhar	esplender
desenlace	desenleio
desenlambuzar	mundificar
desenlamear	mundificar
desenla�ar	desenredar
desenleio	destrin�a
desenli�ar	estri�ar
desenodoar	desnodoar
desenraizar	desraigar
desenrascar	desvencilhar
desenredar	desvincilhar
desenrolar	sucess�o
desenroupado	desnudo
desenrubescer	desmaiar
desentaipar	desentulhar
desentalar	desvincilhar
desentender-se	malquistar-se
desenterrar	evidenciar
desenterroado	esterroado
desentesar	lassear
desentesoirar	encontrar
desentibiar	reflorescer
desentoado	discorde
desentonar	prostrar
desentortar	reparar
desentranhar	esviscerar
desentravar	desestorvar
desentristecer-se	destristecer-se
desentulhar	livrar
desentumecer	desintumescer
desenvencilhado	desenvincilhado
desenvencilhar-se	despegar-se
desenvolto	inquieto
desenvolver	vingar
desenvolver-se	formar-se
desenvolvimento	prosperidade
desenxabidez	insipidez
desenxabimento	mornid�o
desenxavido	dessaboroso
desertar	sair
deser��o	transf�gio
desesperante	desesperativo
desesperar-se	rasgar-se
desestatiza��o	privatiza��o
desestimar	menosprezar
desestruturar	destruir
desfadigar-se	relaxar-se
desfalcar	diminuir
desfalecer	esvanecer
desfarelar-se	esfarinhar-se
desfavorecer	renegar
desfazer	rescindir
desfazer-se	estilha�ar-se
desfa�ado	impudico
desfa�atez	safadeza
desfear	deturpar
desfear-se	desguarnecer-se
desfechar	finalizar
desfeita	inconsidera��o
desfeiteado	injuriado
desfeitear	ultrajar
desfeminizar	masculinizar
desferir	encavilhar
desfiar	esgar�ar
desfibrar	examinar
desfigurado	transformado
desfigura��o	malforma��o
desfilar	processar-se
desflorado	esflorado
desflorescer	murchecer
desflorescimento	fenecimento
desflorestar	desmoutar
desflorir	fanar
desflorir-se	findar
desfolegar	resfolegar
desfolhar	matar
desformar	transmudar
desforrar-se	vingar-se
desfortalecer	desvigorar
desfortunoso	mal-afortunado
desfor�o	saldo
desfraldar	esfraldar
desfrisar	desguedelhar
desfruir	gostar
desfrutar	motejar
desfrute	moca
desgalhar	desramar
desgargalado	esgargalado
desgarrar	empestear
desgastado	surrado
desgastar	devorar
desgaste	eros�o
desgosto	enfado
desgostoso	dissaboroso
desgovernado	estragador
desgovernar	viciar
desgraciado	infortunado
desgra�a	sinistro
desgra�ado	malfadado
desgra�ar	desvirgar
desgra�ar-se	perder-se
desgregar	erradicar
desgrenhar	enredar
desguarnecer	enfear
desguedelhado	esguedelhado
desguedelhar	embara�ar
desidratar	ressecar
designado	nomeado
designar	preceituar
desigual	desirm�o
desigualar-se	desnivelar-se
desiludir	despersuadir
desimanado	desmagnetizado
desimpedimento	desobstru�ncia
desimpedir	safar
desinchado	desintumescido
desinchar	detumescer
desincha��o	detumesc�ncia
desinfeccionar	desinfecionar
desinfesta��o	desinsetiza��o
desingurgitado	livre
desinquietar	tentar
desinquietar-se	incomodar-se
desintegra��o	separa��o
desintelig�ncia	div�rcio
desintumescer	detumescer
desirmanado	diferente
desistir	escorra�ar
deslado	rumo
deslassar	laxar
deslavar	desmaiar
desleal	tredo
deslealdoso	leonino
deslealmente	perfidamente
desleitado	ex�bere
desleixa��o	relaxid�o
deslembrado	olvidado
desligar-se	separar-se
deslindamento	destrin�a
deslisar	turibular
deslizadeiro	resvaladoiro
deslizamento	resvaladura
deslizar	rabear
deslocar	desnocar
deslocar-se	despreender-se
desloca��o	mobiliza��o
deslombado	espancado
deslombar	tarear
deslumbramento	fasc�nio
deslumbrante	fastuoso
deslumbrar	sobrepujar
deslumbre	fasc�nio
deslumbroso	triunfante
deslustrado	empanado
deslustrar	embaciar
deslustrar-se	obscurecer-se
deslustre	empanamento
desluzir	mutilar
desluzir-se	embaciar-se
desmaecer	esmaiar
desmaiar	esfalecer
desmaio	v�gado
desmama	desmame
desmancha	esbor�o
desmanchar	esfacelar
desmandado	intemperante
desmando	exagera��o
desmedrar	emagrentar
desmedroso	ousado
desmelhorar	minar
desmelindrar	jubilar
desmembramento	destroncamento
desmembrar	mutilar
desmembra��o	separa��o
desmemoriado	esquecido
desmemoriamento	esquecimento
desmensur�vel	imensur�vel
desmentar	enloucar
desmentido	negado
desmentir	diferir
desmerecedor	indigno
desmerecer	rebaixar
desmerecimento	desprest�gio
desmiolado	esmiolado
desmiolar	girar
desmiudar	minudenciar
desmiu�ar	estri�ar
desmobilhado	desmobiliado
desmochar	mochar
desmodorrar	excitar
desmoralizar	extraviar
desmoraliza��o	profana��o
desmoronar-se	esfarelar-se
desmoutar	humanizar
desnalgar-se	remexer-se
desnaturamento	distor��o
desnaturar	deteriorar
desnervar	enfraquentar
desnivelar	discernir
desnobrecer	inferiorizar
desnortear	entontecer
desnortear-se	estremunhar-se
desnuar	desnudar
desnudamento	revela��o
desnudo	despido
desnutrir	emagrecer
desobedecer	trespassar
desobedi�ncia	inobserv�ncia
desobrigado	isento
desobrigar	exonerar
desobstru��o	desobstru�ncia
desocupado	vago
desocupar	vaziar
desocupar-se	dispensar-se
desodorado	desodorizado
desolar	ermar
desonerar	liberar
desonera��o	isen��o
desonestar	infamar
desonestidade	doblez
desonrador	desonrante
desonrar	ignominiar
desordem	subvers�o
desordenar	enlabirintar
desordenar-se	perder-se
desorganizar	perturbar
desorganiza��o	desvincula��o
despachar	enviar
despacho	envio
desparecer	ruir
despargir	raiar
despartir	desviar
desparzir	radiar
despassar	pervagar
despatriado	�xule
despavorir	espantar
despeda�amento	dilacera��o
despeda�ar	estilha�ar
despedimento	exonera��o
despedir	rutilar
despedir-se	retirar-se
despegar	estremar
despegar-se	saltar
despego	distanciamento
despeitado	escandalizado
despeitar	encalistrar
despejado	despudorado
despejar	transvazar
despejo	impudor
despentear-se	escabelar-se
desperdi�ado	extravagante
desperdi�ador	esperdi�ador
desperdi�ante	esperdi�ante
desperdi�ar	dissipar
desperecer-se	deturpar-se
despersuadir	tirar
despertar	sacudir
despe�ar	moer
despiolhar	esquadrinhar
despique	saldo
despir	despossuir
despistamento	lud�brio
despistar	emburricar
despojado	espoliado
despojar	orfanar
despojo	presa
despolir	empanar
desponderado	irreflexo
desponta	surgimento
despontar	raiar
desposar	receber-se
despossar	trosquiar
desprazer	ofender
desprecavido	imprevidente
despregar	separar
despregui�ar	escordar
despregui�ar-se	estender-se
desprender	exalar
desprender-se	soltar-se
desprestigiar-se	desvalorizar-se
desprest�gio	queda
desprevenir-se	facilitar
desprez�vel	reles
desprez�vel	p�fio
desprimoroso	mazorral
desproporcionado	desproporcional
despropositado	espinoteado
desproveito	preju�zo
desprovimento	nudez
despumar	escumar
despundonorado	despundonoroso
desp�tico	opressor
desquadrilhar	sovar
desqueixelado	estupefato
desquietar	exagitar
desrabado	rabic�
desraigado	extirpado
desraizar	jugular
desregrado	exagerado
desrespeitar	transgredir
dessaborido	dissaborado
dessangrado	froixo
dessangrar	exaustar
dessecado	insens�vel
dessegredar	pregoar
desservido	escasso
dessim�trico	dissim�trico
dessoante	discordante
dessossegar	remexer
dessossego	fogo
dessoterrar	revelar
dessumir	extrair
destacar	focar
destacar-se	real�ar
destaque	proje��o
destemeroso	impert�rrito
destemido	intimorato
destemperado	imoderado
desterrado	proscrito
desterro	solid�o
desterroador	estorroador
destilar	transcoar
destinar	empregar
destina��o	utiliza��o
destino	sorte
destituir	privar
destitu�do	escasso
destoante	malsoante
destoucar	enfear
destrambelho	doidaria
destratar	ultrajar
destrinchar	individuar
destrin�ar	particularizar
destristecer	triunfar
destro	lesto
destroncado	luxado
destroncar	truncar
destro�ado	dispersado
destro�ar	dissipar
destro�o	dissipa��o
destruir	esfrangalhar
destrutibilidade	fragilidade
desumanidade	malevol�ncia
desumano	subumano
desumidificar	esgotar
desunir-se	esfazer-se
desuni�o	dissens�o
desvaecer	ensoberbecer
desvaecer-se	extinguir-se
desvairado	variado
desvairar	embebedar
desvalidar	revogar
desvalijar	sonegar
desvanear	varrer
desvanear-se	emplumar-se
desvanecer	varrer
desvanecer-se	garguitear
desvariado	v�rio
desvariar	esmaniar
desvelar	elucidar
desvendar	expor
desvergonha	impud�ncia
desvergonhamento	petul�ncia
desviar	esgueirar
desviar-se	escabecear
desvigorar	quebrantar
desvigorizar	exaurir
desvincilhar	estri�ar
desvio	divaga��o
desvirilizar	emascular
desvirtuamento	distor��o
desvirtuar	violentar
desvirtuar-se	perder-se
desvirtua��o	envilecimento
desvitalizado	quebrantado
desvitaliza��o	esgotamento
desv�o	recanto
des�gnio	sorte
detalhar	maquinar
detalhe	particularidade
detectar	distinguir
detector	radar
detento	preso
deter	represar
deter-se	plantar-se
determinado	feito
determinador	determinativo
determinar	ser
determinar-se	empreender
detestado	execrado
detido	vedado
detona��o	disparo
detrair	infamar
detratar	difamar
detruncar	tronchar
deturbar	intranq�ilizar
deturpar	infeccionar
deturpar-se	putrificar-se
devagar	morosamente
devaneador	sonhador
devanear	endoudar
devaneio	faz-de-conta
devassa	sindic�ncia
devassar	esmiu�ar
devassid�o	libidinosidade
devasso	imorigerado
devastar	infestar
devasta��o	razia
deveras	verdadeiramente
devidamente	merecidamente
devolutivo	devolut�rio
devoluto	inabitado
devolver	tornar
devorante	lambaz
devorar	dilapidar
devotamente	religiosamente
devotamento	entrega
devotar-se	votar-se
devo��o	entrega
de�o	decano
de�fico	divinizante
diabrura	molecagem
diab�lico	lucif�rico
diadema	nimbo
diamba	dirijo
dicionarista	lexic�grafo
dicionarizar	vocabularizar
dicion�rio	l�xico
dicot�mico	dic�tomo
did�tico	escolar
dietista	nutricionista
difamado	enodoado
difamante	maledicente
difamar	enegrecer
diferente	variegado
diferen�ar	ver
diferir	retrasar
dificuldade	obstrucionismo
dificultar	fechar
difundir	publicar
difundir-se	disseminar-se
difusamente	largamente
dif�cil	fatigoso
digerir	entuchar
digladiar	triscar
dignidade	gravidade
dignifica��o	nobilita��o
digno	direito
digresso	excurs�o
dilaceramento	rebenta��o
dilacerar	esfarrapar
dilacerar-se	moer-se
dilacera��o	rebenta��o
dilapidador	prodigalizador
dilapidar	esfrangalhar
dilatado	grande
dilat�rio	morat�rio
diligenciar	intentar
diligente	expedito
dilig�ncia	ligeireza
dilucidar	enuclear
diluir	moderar
diluir-se	resolver-se
diluvioso	torrentoso
dil�culo	entremanh�
dimana��o	emana��o
dimens�o	espa�o
diminuir	suavizar
diminuir-se	ir
diminuto	manino
dinheirento	opulento
dinheiroso	ourudo
direcionar	induzir
direcionar-se	encaminhar-se
direito	s�rio
diretor	gestor
dirigente	gestor
dirigido	orientado
dirigir	reger
dirigir-se	rumar
dirruir	subverter
dir�gio	tabanagira
discernimento	exame
discernir	medir
disciplina	mat�ria
disciplinar	sujeitar
discipulado	tiroc�nio
discordante	inarm�nico
discordo	inconson�ncia
discorrer	especular
discrepar	dividir
discreto	judicioso
discurso	predica��o
discuss�o	disputa
discutir	disputar
disfarce	ilus�o
disfar�ar	solapar
disgregar	escindir
disjun��o	exarticula��o
disparar	pregar
disparar-se	esbandalhar-se
disparatar	sonhar
disparo	explos�o
dispensa	dispensa��o
dispensar	prescindir
dispersado	espalhado
dispersar	estro�ar
dispersar-se	estourar
displicente	indolente
dispor	estabelecer
dispor-se	precaver-se
disposi��o	tend�ncia
disputar	triscar
dissaborado	sensabor
dissecar	olhar
disseca��o	dissec��o
dissectivo	dissetivo
disseminar	proclamar
dissenso	diverg�ncia
dissentir	implicar
dissidente	sedicioso
dissimulado	indireto
dissimular	velar
dissimular-se	mascarar-se
dissipado	estr�ina
dissipador	malgovernado
dissipar	malgastar
dissipar-se	extinguir-se
dissipa��o	p�ndega
dissoluto	viciado
dissolver	fundir
dissolver-se	exalar-se
dissolv�ncia	liq�idifica��o
dissonoro	malsoante
dissuadidor	dissuasor
distanciado	espa�ado
distanciador	espa�ador
distanciar-se	distar
distante	sa�do
distender	expandir
distender-se	estiar-se
distens�o	entesamento
distinguido	divisado
distinguir	honorificar
distinguir-se	predominar
distinto	esclarecido
distin��o	realce
distraimento	prazer
distrair	letificar
distrair-se	dormir
distrate	distrato
distra��o	espairecimento
distribuir	ordenar
disturbar	estrompar
dist�ncia	intervalo
ditado	rif�o
ditadura	prepot�ncia
ditar	ordenar
ditatorialismo	governismo
ditinho	intriga
dito	invencionice
diurnal	quotidiano
divagar	flanar
diversicolor	versicolor
diversidade	mudan�a
diversificado	diverso
divers�rio	prazer
divertido	folgaz
divertimento	entretimento
divertir-se	folgazar
dividir	ratear
dividir-se	partir-se
divinizar	extremar
divisado	estremado
divorciado	quite
divulgado	revelado
divulgar	preconizar
diz-que-diz	diz-que-me-diz-que
diz-que-diz-que	voz
dizedor	tagarela
dizer	ferir
di�fano	pel�cido
doar	sacrificar
doa��o	oferta
dobra	sinuosidade
dobradi�a	engon�o
dobradura	vinco
dobramento	vinco
dobrar	pressionar
dobrar-se	tornejar-se
dobrez	hipocrisia
doca	zer�
doce	melieiro
doente	paciente
doestar	escoicinhar
doidaria	maluquice
doideira	doudaria
doidejar	flanar
doirado	dourado
dolente	magoado
dolo	t�bua
doloroso	magoado
dom	habilidade
dom-quixote	quixote
doma	doma��o
domar	sopear
domar-se	vencer-se
domesticar	subjugar
domiciliado	morador
dominador	senhoreador
dominar	reprimir
domina��o	mando
dom�stica	servi�al
dom�nio	unha
donaire	ornato
donairosamente	galhardamente
donairoso	gentil
doneador	galanteador
donoso	galhardo
donzel	singelo
dormente	pl�cido
dormideira	modorra
dorm�ncia	letargo
dotar	prendar
doudejar	vagabundar
doudo	tresloucado
dourar	entusiamar
doutrinar	educar
dozena	d�zia
dram�tico	tocante
drenagem	escoadura
drenar	extrair
dreno	escoadoiro
drogomano	turgim�o
dul�or	mansid�o
duna	m�d�o
dunguinha	rapazola
dupla	par
duplicador	duplicante
duradoiro	dur�vel
duradouro	perdur�vel
durar	subsistir
dureza	intransig�ncia
duro	forte
duvidosamente	hesitantemente
duvidoso	irresoluto
d�ndi	janota
d�vio	dif�cil
d�ade	par
d�ctil	flex�vel
d�lcido	fagueiro
d�vida	incerteza
ebri�tico	embriagante
ebuliente	fervoroso
ebulitivo	fervente
ecfr�tico	picante
eclipsar	sombrear
eclipsar-se	socar-se
eclodir	ressair
eco	retumbo
ecoadouro	escoadoiro
ecoar	retinir
ec�leo	flagelo
edaz	insaci�vel
edificar	instruir
editorar	publicar
editora��o	publica��o
educar	polir
educar-se	polir-se
educa��o	pol�tica
edulcorar	placar
edule	manduc�vel
ed�cula	orat�rio
efeito	�xito
efeituar-se	realizar-se
eferente	ex�dico
efetiva��o	implementa��o
efetuar-se	ocorrer
efundir	esvaziar
efundir-se	espalhar-se
efus�o	emborque
ef�mero	transitivo
ef�gie	translado
ego�smo	fil�ucia
egr�gio	ilustre
eivar	exinanir
eixo	piv�
ejetar	expelir
elabora��o	preparo
elanguescer	prostrar
elanguescido	enfraquecido
elasticidade	flexibilidade
elator	erector
eleg�ncia	glamour
elementar	primordial
elenco	lista
eletrizar	esporar
elevado	empolado
elevar	librar
elevar-se	nobilitar-se
eleva��o	rebitagem
eliciar	esconjurar
elidir	suprimir
eliminar	extinguir
elimina��o	exclus�o
elite	nata
elogiado	louvado
elogiar	plaudir
elogio	enc�mio
eloq�ente	facundo
eloq��ncia	expressividade
elucidar	explicar
elusivo	esquivo
emaciado	emagrecido
emagrentado	mirrado
emalar	empacotar
emanar	transverberar
emancipar-se	resgatar-se
emaranhamento	embara�amento
emascarar	sufocar
emascular	enfraquecer
emascula��o	mutila��o
ema�arocado	emaranhado
embabadar-se	enrugar-se
embaciado	rofo
embaciar	en�ampar
embaciar-se	lograr-se
embaimento	emb�fia
embair	embalar
embalado	iluso
embalador	ilusivo
embalan�ar	menear
embalar	embelecar
embalsamado	olorante
embandeirar	nobrecer
embaralhar	enlabirintar
embaralhar-se	entremisturar-se
embara�ado	torvado
embara�ar	entravar
embara�ar-se	enredar-se
embara�o	engasgamento
embargamento	emperramento
embargo	obst�culo
embarrado	esbarrado
embarrar-se	entujucar-se
embarreirar	fortificar
embarricar	proteger
embarrigado	gr�vido
embasbacado	surpreso
embasbacar-se	surpreender-se
embate	oposi��o
embater-se	esbarrar-se
embatucar	entrela�ar
embatumado	pesado
embatumar	preencher
embaucar	embromar
embaular	esconder
emba�adeiro	emba�ador
emba�ado	logrado
emba�ar	engabelar
emba�ar-se	enganar-se
emba�do	engazopado
embeber-se	empegar-se
embeberar	transir
embebimento	infiltra��o
embei�ado	enrabichado
embei�ar	enfeiti�ar
embelecar	entreter
embelezar	inebriar
embespinhar	exagitar
embespinhar-se	rabiar
embestar	fincar-se
embevecer-se	encantar-se
embevecido	extasiado
embicar	emperrar
embirr�ncia	teimosice
emblema	signa
embodegado	lixento
embolorado	mofado
embolso	remunera��o
embonecar-se	engalanar-se
embonecrar	pendoar
emborca��o	entornadura
emborque	esborro
emborquilhar	transvazar
emborralhar	enlodar
emborralhar-se	nodoar-se
emborrascar	revoltar
embotar	enfraquecer
embotelhar	engarrafar
embramar	enroscar
embrandecer	sensibilizar
embravear	embravecer
embravear-se	esquentar-se
embravecer-se	esturrar-se
embravecido	furibundo
embravecimento	encrespadura
embrenhar	entranhar
embrenhar-se	fundir-se
embretada	embrulho
embretar	sitiar
embriagamento	embriaguez
embriagar	inebriar
embriaguez	inebriamento
embridar	reprimir
embrincar	moldurar
embromar	palhetear
embrulhada	tralhoada
embrulhamento	lud�brio
embrulhar	ludibriar
embrulho	encrava��o
embrumar	nublar
embrumar-se	encangotar-se
embrutar	estupidificar
embuchar-se	locupletar-se
emburrar	embuziar
emburricar	engabelar
embuste	embustice
embustear	gambelar
embusteirice	trapa�a
embusteiro	empulhador
embustice	engano
embutido	encavilhado
embuziar	enlambuzar
embu�alar	trautear
embu�ar	paliar
emb�fia	presun��o
emendar	escarmentar
emergir	mostrar-se
eminente	�nclito
emin�ncia	sali�ncia
emiss�o	expedi��o
emitir	mencionar
emocionante	impressionante
emoldar	formar
emoldurar	revestir
emoldurar-se	ornar-se
emotividade	sensibilidade
empacar	entrela�ar
empachar	fechar
empalecer	menoscabar
empalidecer	menospre�ar
empalmar	saltear
empancar	pejar
empantufar-se	entufar-se
empanturramento	enfarta��o
empanturrar-se	engalar-se
empapado	repassado
empapar	engrampar
empapu�ado	tumefeito
emparelhamento	nivelamento
emparelhar	empatar
empatar	enlear
empavesar-se	envanecer-se
empavonar-se	estadear-se
empavonear-se	envaidecer-se
empa�ocar	machucar
empecilho	tropecilho
empecimento	estorvamento
empedernecer	emperrar
empedernir	endurecer
empedernir-se	incrustar-se
empedrenir	endurar
empedrou�ado	pedregoso
empegar	mergulhar
empegar-se	mergulhar-se
empenado	enfeitado
empenamento	torcimento
empenhorar	obrigar
empenhorar-se	fazer
emperlar	perolar
emperrar	estomagar
empertigado	ereto
empestado	pestilento
empestar	infecionar
empestear	pestear
empe�onhado	pe�onhoso
empe�onhar	prevaricar
empe�onhentar	estragar
empilhamento	sobreposi��o
empinado	encabritado
empinar	virar
empinar-se	engalar-se
empiscar	fulgir
emplacar	enamorar
emplasmado	valetudin�rio
emplastrar	entrapar
emplumar-se	engalar-se
empolado	encapelado
empolgado	seduzido
emporcalhamento	enlameadura
emporcalhar-se	enodoar-se
emporcar	inquinar
empreendimento	firma
empregar	transtrocar
emprenhar	galar
empresa	pressuposto
emprisionar	represar
emproar-se	entufar-se
empulha��o	tapea��o
empurpurar	vermelhecer
empurpurecer	vermelhar
empurrar	socar
empurr�o	encontrada
empuxar	impelir
emudecido	mudo
emula��o	est�mulo
emurchecer-se	murchar-se
enaltar	levantar
enaltecer	exaltar
enantr�pico	end�geno
enastrar	encanastrar
encabe�amento	pref�cio
encabe�ar	sobreintender
encabrestar	submeter
encabulado	vexado
encabular	perseguir
encabula��o	enleio
encacha�ar-se	encarrascar-se
encacho	tangueiro
encadeamento	estrutura��o
encadear	trincafiar
encadea��o	uni�o
encafifado	envergonhado
encafifar	tungar
encafuado	encoberto
encafuar	entocar
encafuar-se	ocultar-se
encafurnar	enlocar
encafurnar-se	refugiar-se
encaixar	introduzir
encaixotar	encavar
encalejar-se	incrustar-se
encalhamento	oposi��o
encalistrar	tempestear
encalmar	judiar
encalvecido	pelado
encal�ar	traquear
encaminhado	guiado
encamisada	qu�
encanastrar	entrela�ar
encandear	ofuscar
encangotar	velar
encangotar-se	escurecer
encantar	enlevar
encantar-se	enfeiti�ar-se
encanto	prumo
encanudado	encanutado
encanutado	tubulado
encanzinado	irado
encapar	entroixar
encapeladura	encrespamento
encapetado	tr�fego
encapotar-se	velar-se
encaramelar	solidar
encarapitar-se	engrimponar-se
encarar	topar
encarceramento	reclus�o
encarcerar-se	enterrar-se
encardir	encarvoejar
encarnar	vermelhar
encarni�ar	provocar
encarochado	enfeiti�ado
encarquilhado	esmarrido
encarquilhar	surcar
encarquilhar-se	enrugar-se
encarrancar	enublar
encarrancar-se	obscurecer-se
encarrapitar-se	engrimpar-se
encarrascar-se	toldar-se
encarregar	recomendar
encarreirar	enveredar
encarreirar-se	rumar
encarrilar	encarrilhar
encarvoado	encarvoejado
encarvoar	enlaivar
encasamento	engrenamento
encasar	inculcar
encasquetar	induzir
encasquetar-se	teimar
encastelar-se	escudar-se
encastramento	entrosamento
encavalgar	montar
encavernar	enlurar
encelar	trincafiar
enceleirar	poupar
encenar	ostentar
encena��o	fantochada
encerrado	incluso
encerrar	enquadrar
encerrar-se	terminar-se
encervejar-se	encharcar-se
encetadura	inaugura��o
enchafurdar	subverter-se
encharcado	palud�fero
encher	enquizilar
encher-se	estufar-se
enchoiri�ar	flagelar
enchouri�ar-se	encrespar-se
encimar	remontar
encintar	enla�ar
enclaustrado	enclausurado
enclausurar-se	recolher-se
encobardar-se	intimidar-se
encobertar	tapar
encoberto	nuvioso
encobrado	enriquecido
encobrimento	recolhimento
encobrir	silenciar
encobrir-se	obnubilar-se
encoimar	increpar
encoirado	encourado
encoirar	encourar
encoira�ar	encoura�ar
encolerizado	irritado
encolerizar	irritar
encolerizar-se	exaltar-se
encolher	intimidar
encolher-se	resignar-se
encomenda	pedido
encompridar	espichar
encondensado	substanciado
encontrar	pegar
encontrar-se	topar-se
encontro	obst�culo
encontr�o	topada
encorajar	reerguer
encorpado	massudo
encorrilhar	encoscorar
encorrugir	enrugar
encorujado	jaruru
encorujar	mirrar
encoscorar-se	refegar-se
encostar	zurzir
encostar-se	esfregar-se
encosto	respaldo
encovar	subterrar
encrassar	inspissar
encrava	enrascada
encravar	enfincar
encravar-se	engastar-se
encravelhar	enrabichar
encravelhar-se	encravilhar-se
encrencar	rodilhar
encrencar-se	enredear-se
encrespar	espetar
encrespar-se	franzir-se
encrespa��o	enfurecimento
encruado	indigesto
encruar	encruecer
encruar-se	excitar-se
encrudelecer-se	envinagrar-se
encruecer	insensibilizar
encruecer-se	escabritar-se
encruentar	tesar
encruentar-se	incitar-se
encruzar	transpor
encruzilhar	rasgar
encumear	engrandecer
encurtar	epilogar
encurvar-se	prostrar-se
enc�clico	redondo
endemoninhado	endiabrado
endemoninhar	irar
endemoninhar-se	envinagrar-se
endentar	entrosar
endenta��o	engrenagem
endere�ar	enviar
endest�sico	endest�tico
endeusamento	potra
endeusar-se	enfunar-se
endiabrado	treloso
endocelular	intracelular
endoidar	ensandecer
endoidecer	endoudar
endoidecer-se	perturbar-se
endoidecido	enlouquecido
endosse	ratifica��o
endoudar	so�obrar
endurar	obdurar
endurar-se	petrificar-se
endurecer	revitalizar
endurecer-se	petrificar-se
endurecimento	pertin�cia
endurentar	esticar
enegrecer	rebaixar
enegrecer-se	entrevar-se
enegrecido	manchado
enegrecimento	inj�ria
energia	valentia
enervador	irritante
enervamento	exaspera��o
enervar	exagitar
enervar-se	estiolar-se
enerva��o	lassid�o
enerve	l�nguido
enevoado	turvo
enevoar	sombrear
enevoar-se	ensombrecer-se
enfadar	monotonizar
enfadar-se	nausear-se
enfadonho	molestoso
enfadoso	peto
enfarar	fartar
enfarar-se	enjoar-se
enfaro	repugn�ncia
enfarruscar-se	turbar-se
enfastiante	ma�ante
enfastiar	fadigar
enfastioso	enjoado
enfatuado	jactante
enfatuamento	entufamento
enfeitado	paramentado
enfeitar	formosear
enfeixar	entroixar
enfenecer	selar
enferrujado	ferrugento
enfestar	estopar
enfezamento	ira
enfezar	massacrar
enfezar-se	importunar-se
enfiada	ramal
enfiar-se	imitir-se
enfim	finalmente
enfiteutic�rio	enfit�utico
enflorado	florejado
enflorar	engalanar
enflorear	ornamentar
enflorescer	resplendecer
enforcar	esganar
enforcar-se	esgoelar-se
enfracado	extenuado
enfraquecido	enfraquentado
enfraquecimento	lassitude
enfraquentar	enlanguescer
enfraquentar-se	quebrantar-se
enfreado	retido
enfreamento	frenamento
enfrear	modicar
enfrenar-se	reprimir-se
enfrentar	entestar
enfrutecer	frutescer
enfunar	pojar
enfunar-se	orgulhar-se
enfuna��o	incha��o
enfurecer	exasperar
enfurecer-se	remorder-se
enfurecido	irado
enfuriar	exaltar
enfurnar	enlocar
enfuscar	obumbrar
enfustar	especar
engabelar	impingir
engaiolar	ferrolhar
engalanar	ornar
engalar-se	envanecer-se
engalfinhar	pegar
engalfinhar-se	rolar
engalhopado	escarnido
engambelar	engrambelar
enganar	pantominar
enganchar	travar
engano	engodamento
engastar	interserir
engatado	unido
engatinhar	gatear
engavelar	faxinar
engazopado	logrado
engelhado	rugoso
engelhar	plicar
engelhar-se	franzir-se
engendrar	ter
engenhar	inventar
engenho	inventividade
engessar	gessar
engoiar-se	escanifrar
engolir	rebater
engomadura	gomagem
engon�o	gonzo
engordurado	enlambuzado
engordurar	enlambuzar
engorovinhado	espadongado
engrambelar	iludir
engrampar	enloisar
engrandecer	qualificar
engranzado	entrosado
engranzagem	entr�s
engranzar	engrazar
engraxador	engraxate
engrazar	enloisar
engra�ado	facecioso
engra�ar	reunir
engrenagem	engrenamento
engrenamento	entrosagem
engrimpar-se	lisonjear-se
engrimpinar-se	pavonear-se
engrimponar-se	estadear-se
engrinaldar	recompensar
engrinaldar-se	grinaldar-se
engrolado	tapeado
engrossar	espessar
engrunhido	malandro
engrupido	escarnecido
engui�ado	macutena
engurujar	retrair
enjerizar-se	envinagrar-se
enjoado	sopor�fero
enjoar	entediar
enlace	uni�o
enlambuzar	ensebar
enlamear	manchar
enlamear-se	pandilhar-se
enlanguescente	languescente
enlanguescido	prostrado
enlapado	refugiado
enla�ar	estreitar
enla�ar-se	prender-se
enlear	enredar
enlear-se	enredear-se
enleio	envolvimento
enlevado	inebriado
enlevamento	rebitagem
enlevar	envolver
enlevo	�xtase
enlinhar	perturbar
enli�ar	fraudar
enlodar-se	envilecer-se
enlousar	enviscar
enobrecimento	notabiliza��o
enoiri�ar	ouri�ar
enoitecer	toldar
enojar	escoucear
enojar-se	entediar-se
enovelar-se	enrolar-se
enquadramento	inclus�o
enquadrar	possuir
enraivado	enraivecido
enraivar	indignar
enraivecer	escandescer
enraivecer-se	raivejar
enraivecido	iracundo
enrascadela	qu�
enrascar	tungar
enredadeira	lena
enredado	implexo
enredador	maranhoso
enredar	enredear
enredear	ma�arocar
enredear-se	intrincar-se
enredo	mat�ria
enregelar	gelar
enregelar-se	gelar-se
enrenquear	perfilar
enricar	enriquecer
enrijar	revigorar
enrijecer	revigorar
enrijecer-se	retesar-se
enrinconar	rinconar
enrodilhar	trautear
enrodilhar-se	enrolar-se
enrolado	rol�
enrolar	velhacar
enrolar-se	equivocar-se
enroscamento	parafusa��o
enroscar	estreitar
enroscar-se	intricar-se
enroupar-se	velar-se
enroxado	enroxecido
enrubescer	esfoguear
enrugado	rugado
ensaboar	recriminar
ensaburrar	ferretar
ensacar	entroixar
ensaiar	industriar
ensang�entar	purpurear
ensebado	sebento
ensecar	exaurir
ensejar	produzir
ensejo	hora
ensementar	estender
ensinar	indicar
ensoalheirado	ensolarado
ensoberbar-se	inflar-se
ensoberbecer-se	intumescer-se
ensombrar	enturbar
ensombrecer	sombrear
ensombro	toldo
ensopado	repassado
entabuar	solhar
entabular	incoar
entaleigar	preencher
entalha	talha
enteato	enteu
entecer	entretecer
entediado	farto
entediante	sopor�fico
entelhado	imbricado
entender	imaginar
entendido	percebido
entenebrecer	sombrear
entenebrecer-se	negrejar-se
entesamento	estir�o
entesar	esticar
entesoirador	tesaurizador
entibiar	extenuar
entoar	soar
entojar	flagelar
entontecer	zonzar
entornar	estragar
entornar-se	esparzir-se
entorpecer	imotar
entortadura	tor�o
entrada	porta
entrajar	envergar
entrajar-se	tratar-se
entranqueirar	fortificar
entrar	vaziar
entravar	pausar
entrave	obst�culo
entreaberto	soaberto
entreabrir	florir
entrebranco	exalvi�ado
entrecruzar-se	travar-se
entredizer	entrefalar
entregador	tredo
entregar	sacrificar
entregar-se	vagar
entreluzir	relumear
entremesclar	obscurecer
entremesclar-se	misturar-se
entremeter	intermediar
entremez	sainete
entreouvir	sentir
entrepausa	intercad�ncia
entrepor	intermeter
entressachar	intervalar
entressemear	recortar
entretecer	obrar
entreter	negacear
entreter-se	vadiar
entretido	recreado
entrevar	ofuscar
entrever-se	vislumbrar
entrezar	travar
entrincheiramento	tapigo
entrincheirar	valar
entristecedor	entristecente
entristecer	ferir
entristecer-se	estiolar-se
entroniza��o	exalta��o
entrosar	recompor
entrouxar	ordenar
entrouxar-se	refugiar-se
entufar	inturgescer
entufar-se	envanecer-se
entulhar	preencher
entupir	tapar
entupir-se	fechar-se
enturvar	nevoar
entusiasmar	excitar
entusi�stico	fervente
enunciado	expresso
enunciar	mencionar
enuviar	sombrejar
envaidar-se	estadear-se
envaidecer	pavonear
envaidecer-se	intumescer-se
envalar-se	fortificar-se
envanecer	inchar
envanecer-se	inflar-se
envasadura	envasilhamento
envelope	involut�rio
envencilhado	implexo
envencilhar	jungir
envenenar	putrefazer
envenenar-se	intoxicar-se
enverdecer	verdejar
enverdecer-se	reverdecer-se
envergar-se	zumbrir-se
envermelhar	vermelhear
enviesar	inclinar
envigorar	vigorar
envilecedor	rebaixador
envilecer	rebaixar
envinagrar-se	reprurir-se
enviperado	furente
enviperar-se	exceder-se
envi�ado	fresco
envolto	revolto
envolver	reprimir
envolver-se	implicar-se
envolvimento	sedu��o
envolv�ncia	hipnotiza��o
enxadrezar	escaquear
enxadrista	xadrezista
enxame	pelot�o
enxamea��o	enxameamento
enxergar	perceber
enxofrar	irritar
enxovalhado	infamado
enxovalhamento	m�cula
enxovalhar	impurificar
enxovalhar-se	mediocrizar-se
enxugadoiro	varal
enxugo	varal
enxundiar	nutrir
enxurdar-se	ingurgitar-se
enxurdeiro	tujucal
enxurrada	reponta
enxuto	seco
enzonzar	estontear
en�ampar	velhaquear
epic�dio	lamenta��o
epilogar	trancar
epitomar	recapitular
ep�stola	missiva
ep�tome	s�mula
equalizar	uniformizar
equilibrar-se	ter-se
equivaler	valer
equivocar	trocar
equ�nimo	justo
equ�voco	trocado
eq�itativo	�ntegro
erector	eretor
eremita	ermita
ere��o	levantadura
erguer	formar
erguer-se	suspender-se
erijar	inteiri�ar
ermita	ermit�o
ermo	tebaida
erodir	rafar
erosar	rafar
erotismo	sensualidade
erotiza��o	sensualiza��o
errabundo	vagamundo
errado	err�neo
errar	perambular
erri�ar-se	hispidar-se
erro	falha
erubescer	rosar
erudito	lido
eruginoso	ruvinhoso
ervadura	voorara
esbambear	folgazar
esbandalhado	esfarrapado
esbandalhar	estrin�ar
esbandulhado	esbarrigado
esbanjador	estr�ina
esbanjamento	prodigaliza��o
esbanjar	malgastar
esbarrar	refugar
esbarrondadeiro	resvaladoiro
esbodegado	estragado
esbofamento	exaust�o
esborcelar	esbrucinar
esbordoar	rachar
esborniar	frangalhotear
esboroamento	rebenta��o
esboroar	esbroar
esborrachar	esmurrar
esborro	vertedura
esbo�ar	idear
esbracejar	espernear
esbrasear-se	ruborizar-se
esbravear	mugir
esbravejar	expluir
esbregue	pito
esbroar	esfarelar
esbulho	esp�lio
esburacar	furacar
esburaquento	furado
esb�rnia	p�ndega
escabichar	esmerilhar
escabreado	exasperado
escabritar	revoltar
escabritar-se	estomagar-se
escabroso	fragoso
escachar	fender
escadeirar	zurzir
escalar	saquear
escalavradura	escoria��o
escalavrar	estrompar
escalda	escald�o
escaldar	incendiar
escaldar-se	penitenciar-se
escalpar	funestar
escalpelizar	rebater
escambado	trocado
escambichar	rachar
escamotar	esponjar
escamotear	unhar
escampar	evadir
escam�fero	escamoso
escancarar-se	mostrar-se
escandalizar	ferir
escandalizar-se	picar-se
escandaloso	indecente
escandescer	pruir
escanelado	escanifrado
escangalhado	espeda�ado
escaninho	recondit�rio
escapada	fuga
escapamento	escoamento
escapar	escapar-se
escapar-se	livrar-se
escape	esc�pole
escapulir	evitar
escapulir-se	livrar-se
escarafunchar	examinar
escarapelar	escarpelar
escarc�u	grita
escarmentar-se	flagelar-se
escarmento	increpa��o
escarnecedor	ir�nico
escarnecer	pagodear
escarnecido	escarnido
escarnido	mistificado
escarnificar	setear
escarninho	trocista
escarnir	trotear
escarpamento	talude
escarpelar	esgatanhar
escarranchado	escarrapachado
escarrapachado	esgarranchado
escarrapi�ar	pentear
escascar	escovar
escasseado	falho
escassez	m�ngua
escasso	minguado
escavacar	estro�ar
escavar	esvaziar
escava��o	po�o
esclarecer	interpretar
esclarecido	explicado
escoadura	escorr�ncia
escoicear	respingar
escoicinhador	escouceador
escojura��o	jura
escola	imitadores
escolha	indica��o
escolher	seletar
escolhido	selecionado
escolho	sirtes
escondedoiro	esconderijo
escondedouro	esconso
esconder	guardar
esconder-se	transpor-se
esconderijo	rinc�o
escondido	escuso
esconjurar	repelir
esconjurar-se	querelar-se
esconjuro	jura
esconso	recondit�rio
escopo	mira
escorchar	sobnegar
escoriar	limpar
escorificar	expurgar
escornar	escornichar
escorra�ar	espancar
escorregadio	liso
escorregar	falhar
escorreg�vel	resvaladi�o
escorreg�o	escorrego
escorrer	exsudar
escorr�ncia	liq�idez
escor�o	rascunho
escouceador	escoucinhador
escovar	increpar
escravizar	tiranizar
escravizar-se	submeter-se
escrever	insculpir
escrit�rio	escrivaninha
escrut�vel	perscrut�vel
esculhambar	infecionar
esculpir	talhar
escumante	espum�gero
escumoso	espum�gero
escupidor	estatu�rio
escurecer	marear
escurentar	turvar-se
escurid�o	negrura
escuro	turvo
escusado	sup�rfluo
escusar	inocentar
escusar-se	ressalvar-se
escusa��o	raz�o
escuso	suspicaz
escus�vel	superv�cuo
esc�rnio	lud�brio
esc�lio	nota
esfacelar	esfrangalhar
esfacelar-se	rebentar-se
esfachear	lascar
esfalecer	esmorecer
esfalfar	matar
esfaqueador	esfaqueante
esfaquear	estoquear
esfarelamento	esmigalhadura
esfarelar	esfarinhar
esfarinhar-se	migar-se
esfarrapado	mal-entrajado
esfarrapamento	rasgamento
esfazer	gastar
esfazer-se	exalar-se
esferal	esf�rico
esfiar	narrar
esfing�tico	nebuloso
esfoguear	pruir
esfoguear-se	rosar-se
esfoladela	esfoladura
esfolhar	exterminar
esfomeado	esganado
esfomea��o	voracidade
esfor�ado	estr�nuo
esfor�ar-se	fazer
esfor�o	luta
esfrangalhar	farrapar
esfrega	ralha��o
esfrega��o	esfregadura
esfriamento	resfriamento
esfriar	ter
esfuziar	vagalumear
esfuzilar	prefulgir
esgadelhado	esgrouviado
esganado	som�tico
esgarrar-se	viciar-se
esgoelamento	gritadeira
esgoelar	estrilar
esgotado	mo�do
esgotamento	esgoto
esgotante	extenuativo
esgote	exaust�o
esgravatar	palitar
esgrimir	litigiar
esguichar	espadanar
esmadrigar	perder-se
esmaecer	extinguir-se
esmagar	inquerir
esmaniar	tresvariar
esmeraldear	esverdear
esmerar	esmerar-se
esmerar-se	timbrar
esmerilhar	limar
esmigalhadura	esmigalhamento
esmiudar	perscrutar
esmiu�ar	rastejar
esmolambado	pelintra
esmondar	sachar
esmorecer	esvaecer
esmurra�ar	esmurregar
espacejar	procrastinar
espacejar-se	estender-se
espadeirada	estocada
espalhafato	vozearia
espalhafatoso	mirabolante
espalhar	juncar
espalhar-se	semear
espanar	espoar
espancar	tundar
espandongar	romper
espanejar	espenejar
espanholada	fanfarronice
espantado	sobressaltado
espantar	surpreender
espantar-se	surpreender-se
espanto	sobressalto
espantoso	horr�fero
espargido	vertido
esparramo	pega
esparzir	lan�ar
espaventar-se	sobressaltar-se
espaventoso	estrondoso
espavorecer	estarrecer
espavorizar	transir
espa�ado	espacioso
espa�ar	vastar
espa�o	trecho
espa�oso	grande
especar	estacar
especificado	minudente
especificador	especificativo
especificar	precisar
especifica��o	particulariza��o
especioso	v�o
espectro	visagem
especular	trabalhar
espeda�ado	estro�ado
espelhento	luminoso
espenicar-se	ornar-se
espeque	estronca
espera	expecta��o
esperado	prov�vel
esperan�a	pensamento
esperar	ficar
esperdi�ador	manirroto
esperdi�ante	gastador
esperdi�ar	prodigalizar
espertalh�o	sabido
espertar	sacudir
esperteza	subtilidade
espesso	nubiloso
espetaculosidade	grandiloq��ncia
espetaculoso	luxuoso
espetar	traspassar
espetro	simulacro
espevitar-se	incitar-se
espezinhado	menosprezado
espezinhar	sobrecarregar
espica�ar	magoar
espigado	gra�do
espigar	prosperar
espinhal	espinheiral
espinhar	exaltar
espinhar-se	fumar
espinho	ferr�o
espinicado	janota
espinoteado	estouvanado
espiolhar	vasculhar
espipocar	estralar
espirar	odorar
espiritualmente	mentalmente
espirituoso	facecioso
espirrar	jorrar
espirrar-se	estomagar-se
espirro	esternuta��o
espir�culo	resfolegadoiro
esplandecer	fulminar
esplendecer	flamejar
esplender	resplender
esplendorar	rutilar
espl�ndido	esplendoroso
espoliativo	espoliat�rio
esponjar	furtar
esporada	ferroada
esporar	prurir
esporear	inflamar
esposar	professar
espostejar	estilhar
espraiar-se	esticar-se
espremer	estringir
espumante	furente
esp�cia	especiaria
esp�cie	laia
esp�culo	pua
esp�rita	espiritista
esquadrinhar	procurar
esquartejado	retalhado
esquecido	preterido
esquentar	irar
esquerdo	estouvado
esquina	rebarba
esquipado	guarnecido
esquip�tico	extravagante
esquisitice	exoticidade
esquisito	estranho
esquiva	evas�o
esquivar	remediar
esquivar-se	eximir-se
esqu�rola	estila
essencialidade	necessidade
ess�ncia	subst�ncia
estabalhoado	estouvado
estabelecer-se	fixar-se
estabelecimento	instaura��o
estabilidade	firmeza
estabilizar	fixar
estacional	im�vel
estadear	ostentar
estafa	exaust�o
estafado	pu�do
estafar	fadigar
estagnar	imotar
estala	estrebaria
estalador	estralante
estalar	saltar
estalido	traque
estampar-se	patentear-se
estampilhar	portear
estancar	parar
estanciar	habitar
estanciar-se	gasalhar-se
estapaf�rdico	estapaf�rdio
estaquear	mancar
estarrecer	fulminar
estatelado	im�vel
estatuto	lei
esteio	sustent�culo
esteira	relheira
estendal	varal
estendedouro	varal
estender-se	prolongar-se
estenografado	taquigrafado
estent�reo	estentoroso
esterilidade	pouquid�o
esterilizar	exaurir
esterqueiro	monturo
esterroado	estorrado
estertor	sarrido
esticado	retesado
esticar	inteiri�ar
estic�o	puxada
estigmar	notar
estila	estilha
estilar	gotejar
estilhar	estrin�ar
estilha�ar	estilhar
estilizar	sutilizar
estimar	jubilar-se
estimular	impelir
estiolar-se	queimar
estipula��o	termos
estirado	tenso
estira�ar	repuxar
estirpe	genealogia
estoirar	estourar
estoiro	trov�o
estomagar	melindrar
estomagar-se	torvar-se
estontear	zonzear
estopar	madornar
estorcegar	estrafegar
estorricado	ressequido
estorricar	torrar
estorvar	pejar
estourar	estrugir
estrabar	laxar
estradear	mandar
estragar	tra�ar
estragar-se	gastar-se
estralar	pipoquear
estralejar	pipoquear
estramontado	sanhoso
estrangeiro	forasteiro
estrangulamento	sufoca��o
estranhar	ralhar
estra�alhar	estra�oar
estra�alhar-se	romper-se
estrebaria	persigal
estrebuchar-se	remexer-se
estreitar	minuir
estreiteza	pen�ria
estrelante	rutilante
estrelar	fuzilar
estremecer-se	gelar-se
estrepitoso	soberbo
estriado	zebrado
estriar	raiar
estricto	preciso
estrilar	estrondear
estrin�ar	fragmentar
estripar	eviscerar
estripulia	molecagem
estrito	restrito
estroinar	patuscar
estrompar	minar
estrondar	estrondear
estrondear	troar
estrondoso	sumptuoso
estropiador	mutilador
estropiar	tronchar
estrovinhar-se	perturbar-se
estro�ar	monotonizar
estrugir	rebombar
estruir	perder
estr�bico	vasqueiro
estr�pito	ribombo
estudar	habilitar-se
estufa	fog�o
estufar-se	tumefazer-se
estugar	provocar
estulto	pateta
estuoso	febricitante
estupefazer	pasmar
estupeficar	pasmar
estupendo	maravilhoso
estupidamente	violentamente
estupidez	parvo�ce
estupidificar	materializar
estuporar	perder
estuporar-se	imobilizar-se
esturrar	rugir
est�bulo	estala
est�mulo	sugest�o
est�ptico	est�tico
esvaecer	expungir
esvaecer-se	esvanecer-se
esvair-se	subtilizar-se
esvanecer-se	evolar-se
esvazar	verter
esvaziamento	vaziamento
esvaziar	vazar
esverdeado	verdolengo
esvoejar	voltejar
eternidade	infinitude
eternizar-se	perpetuar-se
eterno	imperecedoiro
etiqueta	praxe
euforia	j�bilo
euf�nico	melodioso
eumatia	subtilidade
evadir	zarpar
evadir-se	eximir-se
evaporar	liberar
evasiva	salvat�rio
evasivo	sutil
eventual	ocasional
everter	so�obrar
evidenciar	expirar
evidenciar-se	patentizar-se
evoca��o	revoca��o
evolar-se	liberar
exabund�ncia	prodigalidade
exacerbado	irritado
exacerbar	exasperar
exacerbar-se	malignar
exagerar	rebuscar
exagitar	marfar
exagitar-se	excitar-se
exalar	externar-se
exaltar	vulcanizar
exaltar-se	presumir
examinar	perscrutar
exasperado	furibundo
exasperar-se	irritar-se
exatamente	mesmo
exaurir-se	gastar-se
exaustivo	extenuador
exaust�o	sobernal
excecionalidade	originalidade
excedente	sobra
exceder	preceder
excelente	perfeito
excelsitude	pujan�a
excel�ncia	magnific�ncia
excepcionalmente	extraordinariamente
excerto	extrato
excessividade	superfluidade
excessivismo	redund�ncia
excetiva	reserva
excita��o	inquieta��o
excluso	repelido
exclus�o	expuls�o
exclu�do	suprimido
excogitar	pensar
excre��o	expuls�o
excruciar	torturar
exculpar	exonerar
exculpa��o	justificativa
execra��o	raiva
execr�vel	trasvisto
executar	ocupar
exemplificar	ilustrar
exemplo	li��o
exercer	experienciar
exercitar	trenar
exibir	p�r
exibi��o	ostenta��o
exig�idade	insufici�ncia
exilar-se	exular-se
eximir	liberar
existir	ser
exonerar-se	isentar-se
exonera��o	isen��o
exorar	pedir
expandimento	extrovers�o
expandir	veicular
expatriado	�xule
expediente	recurso
expedito	lesto
expelido	expirado
expelir	rojar
experienciar	vivenciar
experimentado	matraqueado
experimentar	tentar
experi�ncia	pr�tica
experto	mestre
expia��o	purifica��o
expirar	patentizar
explanativo	explanat�rio
explicar	instituir
explicar-se	ilustrar-se
explica��o	justificativa
explodir	expluir
explorar	lustrar
explora��o	parasitismo
expor	submeter
exposi��o	sujei��o
expressar	exprimir
express�o	gesto
exprobar	glosar
expulsar	expungir
expurgar	lavar
exsicar	ressecar
exsolver	liq�idar
exsuar	transudar
exsurgir	levantar
extasiado	pasmo
extens�o	for�a
extenuar	languescer
exterioridade	superficialidade
exterminar	mandar
extinguir	solver
extin��o	oblitera��o
extorquir	roubar
extra-humano	ultra-humano
extra-sens�vel	ultra-sens�vel
extrair	intuir
extraordin�rio	invulgar
extrapassar	sobreexceder
extrato	fragmento
extravaganciar	malbaratar
extravagante	incr�vel
extravag�ncia	ratada
extravasar	redundar
extraviar	pestear
extraviar-se	perder-se
extremado	supremo
extremar	reduzir
extremar-se	sublimar-se
extremidade	fim
extremismo	radicalismo
exuberar	pulular
exulcerar	ulcerar
exultar	iluminar-se
ex�guo	minguado
ex�mio	preclaro
e�nico	e�nio
fabricar	imaginar
fabrico	produto
fabular	mangar
fabulizar	petar
fabuloso	quim�rico
facalh�o	facalhaz
faccionar	insubordinar
facetar	refinar
facetear	motejar
facilitar-se	prestar-se
facioso	sedicioso
faculdade	vantagem
facultoso	opulento
fad�rio	fortuna
fagueiro	namorado
faina	lide
faiscante	tremeluzente
faiscar	relampadejar
faixa	ligadura
falace	frustrat�rio
falacioso	tunador
falado	insigne
falador	loquaz
falange	multid�o
falar	impor
falat�rio	rumor
falaz	mentido
falcado	falcular
falcatrua	marotagem
falda	sobp�
falecer	necessitar
falecido	morto
falecimento	finamento
falha	imperfei��o
falhado	fissurado
falhar	fracassar
falho	lacunar
falseamento	malsina��o
falsear	violentar
falta	imperfei��o
faltar	trope�ar
fal�ncia	falimento
fanado	torrado
fanar	jarretar
faneco	seco
fanfarrada	farelice
fanfarrice	farfalhice
fanfarronar	pespontar
fanfarr�o	loroteiro
fanfurri�o	farofeiro
fantasista	quimerista
fantasmagoria	visagem
fantochada	fita
fant�stico	incompar�vel
far-niente	�cio
fara�nico	luxuoso
farda	uniforme
fardagem	roupagem
farejar	profetar
farelo	rebotalho
farfalhada	rumorejo
farfante	vaniloq�ente
farinheiro	farinhudo
farnel	merenda
faro	vento
faroleiro	lanterneiro
farp�o	fisga
farra	festan�a
farraparia	fragalho
farrear	fragalhotear
farronca	roncaria
fartar	mantear
fartar-se	repimpar-se
fascinador	sedutor
fastoso	suntuoso
fastuoso	principesco
fatal	inevit�vel
fatigante	paulificante
fatigar	flagelar
fatiloq�ente	prof�tico
fatiota	indumento
fatura	labor
fat�dico	fatiloq�ente
fat�vel	faz�vel
faustoso	soberbo
faustuoso	soberbo
faveiro	potoqueiro
favor	gra�a
favorecer	sorrir
favorecer-se	prevalecer-se
favorito	preferido
favor�vel	pertinente
fazer	praticar
fa��o	fac��o
fealdade	fei�ra
febril	pir�tico
fechar	impedir
fecundar	vivificar
fecundidade	uberdade
fec�ndia	riqueza
fedegoso	fedorento
feio	insuport�vel
feiticeira	maga
feiti�o	malef�cio
fei��o	pinta
fel	travo
felicidade	fortuna
felicitar-se	gratular
fementido	frustrat�rio
feminil	inviril
fenda	rachadela
fender	gretar
fenecer	prontificar
fenecido	torrado
fenomenal	portentoso
feriado	folga
ferida	p�stula
ferido	sentido
ferimento	rasp�o
ferir	vibrar
fermentar	preocupar
ferment�ceo	fermentante
feroz	sanguinolento
ferrabr�s	mata-mouros
ferrado	recalcitrante
ferramenta	utens�lio
ferrar	travar
ferretoar	increpar
ferro-velho	sucata
ferroar	repreender
ferrolhar	subjugar
fertilidade	riqueza
fervilhar	pulular
festeiro	foli�o
fiada	ros�rio
fian�a	segureza
fibra	for�a
ficar	valer
ficha	registro
fichamento	registro
fict�cio	fingido
fidalgaria	nobreza
fiel	sect�rio
figura	ilustra��o
figurado	metaf�rico
figurar	retratar
fila	linha
filhar	filiar
filtrar	procurar
fil�o	veia
fim	limite
final	improrrog�vel
finalidade	papel
finar-se	findar
finca-p�	teimosia
fincar	meter
fincar-se	obstinar-se
findar	tornar-se
fineza	penetra��o
fingidamente	simuladamente
fingir	furtar
finito	limitado
fino	gracioso
finura	sutileza
fin�rio	maquiav�lico
firma	rubrica
firmar	prender
firmar-se	fundar-se
firma��o	fortalecimento
firme	segurado
firmeza	seguridade
fiscalizar	patrulhar
fiscela	morda�a
fissuramento	gretadura
fitar	olhar
fixador	fixante
fixar	mandar
fixar-se	implantar-se
fixa��o	grava��o
flagelar	varar
flagelar-se	lacerar-se
flagela��o	martiriza��o
flagelo	zorrague
flagrar	pegar
flamante	rebrilhoso
flamejar	fulminar
flam�fero	flam�gero
flam�neo	n�tido
flato	flatul�ncia
flatuloso	flatuoso
flatul�ncia	gases
flauteio	trote
flectir-se	fletir-se
flegma	traspasso
flente	lacrimante
fleum�tico	mole
flex�vel	male�vel
floreado	fl�reo
florear	floretear
florescer	vingar
floretear	sobredourar
flutuador	salva-vidas
flutuar	patetear
fluviano	fluvi�til
fl�meo	rebrilhoso
fl�bil	triste
focalizar	marchetar
focar	salientar
focinhada	trombada
fofo	mole
fofoqueira	mexeriqueira
fogos	foguete-do-ar
fogosidade	impetuosidade
fogoso	impetuoso
foguear	ruborizar
foguete	roj�o
foito	resoluto
folgado	largo
folgador	galhofento
folgar	soltar
folgazar	jubilar-se
folgaz�o	p�ndego
folha	jornal
folhada	folhedo
folhado	folhagem
folhar	folhear
folhea��o	folia��o
folhedo	ramaria
folheiro	latoeiro
folia	noitada
fontal	gerador
fontanal	fontano
fonte	motivo
fon�grafo	gramofono
foragido	homiziado
forcado	garfo
forjado	maquinado
forjar	mascavar
forma	talhe
formal	manifesto
formalidade	requifife
formalizado	melindrado
formalizar-se	melindrar-se
formando	graduando
formar	nutrir
formar-se	operar-se
forma��o	funda��o
formica��o	formigamento
formidando	horr�pilo
formidoloso	t�trico
formid�vel	magn�fico
formigar	pulular
formolado	formolizado
formosentar	tecer
formoso	preclaro
formular	presentar
fornecer	produzir
fornir	munir
forrar	picuar
forrar-se	roupar-se
fortalecer	oxigenar
fortalecer-se	renovar-se
forte	musculoso
fortificar	vitalizar
fortificar-se	oxigenar-se
fortifica��o	pra�a
fortuito	impensado
for�a	robustid�o
for�ado	violentado
fosquinha	trejeito
fosso	rego
fota	trunfa
foto	retrato
fracalh�o	medroso
fraco	poltr�o
fragalheiro	molambudo
fragmentar	partir
fragmentar-se	quebrar-se
fragor	trov�o
fragrante	odor�fico
fraldeiro	fraldisqueiro
francamente	lealmente
franc�filo	gal�filo
franger	pregar
frang�vel	r�ptil
franquear	palrar
fraturado	quebrado
fraturar	quebrar
fraudar	tolher
fraude	logro
fraudento	fraudulento
fra��o	parcela
frear	moderar
frege	tasca
frender	irritar-se
frenesi	impulso
frenesiar	irritar
frente	rosto
fren�tico	impaciente
freq�ente	ininterrupto
fresca�o	frescalhote
fresco	recente
frescor	viveza
fressura	pacuera
friagem	frialdade
frialdade	gelidez
friccionar-se	ro�ar-se
friento	friorento
frio	g�lido
frioleira	palha
friso	quebra
froixo	relaxado
fronteiro	lim�trofe
frouxeza	moleza
frouxo	mole
fruir	ter
frustrado	v�o
frustrar	gorar
fr�gido	glacial
fr�volo	oco
fugaz	moment�neo
fugida	retirada
fugido	tresmalhado
fugir	zarpar
fugitivo	transitivo
fulgentear	fulgir
fulgir	tremer
fulgor	rutila��o
fulgurar	sobrelevar-se
fulguroso	nitente
fulg�ncia	resplandor
fulminar	resplandecer
fumar	tabaquear
fumarar	vaporar
fumo	petema
funcionalidade	funcionarismo
funcionar	trabalhar
fundado	fundamentado
fundamentar	motivar
fundar-se	jogar
fundido	liquefato
fundir	prodigalizar
fundir-se	submergir-se
fund�o	p�lago
funestar	verberar
funesto	sinistro
furacar	lurar
furac�o	torvelim
furar	transir
furdun�ar	pagodear
furfur�ceo	furf�reo
furibundo	irado
furiosidade	veem�ncia
furreca	rid�culo
furtar	rapinhar
fustigar	vergastar
fus�o	liquefa��o
futucar	zarelhar
futura��o	hip�tese
futuro	porvindouro
futuroso	prometedor
fuxicar	onzenar
fuzilar	luziluzir
fu�ar	xeretar
f�tuo	jatancioso
f�	religiosidade
f�tido	putrefeito
f�fio	ordin�rio
f�lgido	resplendoroso
f�meo	f�mido
f�nebre	funeral
f�sil	fus�vel
gabador	rebol�o
gabar-se	timbrar
gabarolice	orgulho
gaba��o	ufania
gabela	gavela
gabo	vaidade
gab�o	sobretudo
gadelhudo	guedelhudo
gafe	papel�o
gaguejar	tartamudear
gaiola	pris�o
galact�fago	lact�fago
galanar	janotear
galantaria	gentileza
galanteado	requestado
galantear	ornar
galanteio	xod�
galarada	ramagem
galardoar	pagar
galear	janotar
galgar	vingar
galhardo	garboso
galhofear	pagodear
galicisparlar	galicizar
galonar	louvar
galrar	presumir
galreador	galrejador
gambelar	tungar
gambeteador	gambeteiro
gamb�rria	sancadilha
gamela	pilheta
gana	voracidade
gandaiar	vagamundear
gandaiice	sarandagem
gang	gangue
ganhar	reconvir
gan�ncia	ganhos
garabulhar	rabiscar
garabulho	garavunha
garalhar	papaguear
garantir	resguardar
garantir-se	precautelar-se
gargalo	pesco�o
garganteado	trinado
gargant�o	glut�o
garguitear	ufanar-se
garotada	molecada
garotagem	pequenada
garotar	vagamundear
garrear	tomar
garrido	pimp�o
garrir	papear
garrochar	picar
garrulante	palavreador
garrular	prosear
garrulice	parolice
gar�otas	plumeiro
gasalhar-se	recobrir-se
gases	vento
gastador	perdul�rio
gastar	maleficiar
gastar-se	ir-se
gasto	safado
gatafunhos	gatimanhos
gatear	rapinhar
gatimonha	micagem
gatunagem	rapina
gatunar	unhar
gatunhar	palmear
gatunice	rapinagem
gatuno	ratoneiro
gauderiar	goderar
gear	gelar
gebo	mal-apresentado
geladeira	geleira
gelar	regelar
gelar-se	regelar-se
gelatinoso	pegadi�o
gelosia	r�tula
gemido	plang�ncia
generalidade	universalidade
generalizar	preconizar
generosidade	gentileza
generoso	ubertoso
genetriz	genitora
gentil	prazenteiro
genu�no	particular
geoclimat�rico	geocl�mico
geral	un�nime
gerenciar	manejar
gergelim	zirzelim
germanado	irmanado
germanar	igualizar
germe	princ�pio
germinar	levantar
ger�ncia	gest�o
gesticula��o	pantomima
gestor	superintendente
gingar	palhetar
girante	rotativo
girar	mercanciar
gladiar	questionar
glanduliforme	glanduloso
globosidade	rotundidade
glomerar	lotar
gloriar-se	timbrar
glorificador	glorificante
glorificar	santificar
glorificar-se	jactar-se
gloss�rio	l�xico
glutinoso	peguenhento
glutonaria	voracidade
goelar	vociferar
goguento	gosmoso
gog�	n�-de-ad�o
golada	trago
golelheiro	loquaz
golfar	verter
golpe	pancada
golpear	torturar
gomo	pimpolho
gomoso	viscoso
gonzo	missagra
gorar	naufragar
gordalhufo	gord�o
gorda�o	gordalhufo
gordo	untuoso
gordurento	graxo
gorjeado	trilado
gorjear	trinar
gorjeta	molhadela
gostar	prezar
gosto	paladar
gostoso	s�pido
gotear	transudar
goteira	quelha
gotejar	transudar
governar	tronejar
gozar	sotaquear
goza��o	gra�a
gozo	usufruto
gracejar	joguetear
gracejo	picueta
graceta	picuetada
gracioso	serelepe
gradua��o	graduamento
gralhar	palavrear
gralhear	tarelar
grandalh�o	grand�o
granda�o	grandalh�o
grande	profundo
grandeza	intensidade
grandiosidade	impon�ncia
granir	pontilhar
granja	quinta
grassar	propalar-se
grau	predicamento
gravame	v�nculo
gravar	inscrever
gravidade	import�ncia
graxo	untuoso
grazinar	resmonear
gra�a	pico
grecol�trico	helenol�trico
gretar	rachar
grilhagem	grilh�o
grimpa	ventoinha
grisisco	ru�o
grita	vozearia
gritada	tagarela
grito	reivindica��o
grossaria	grossura
grosso	mal-educado
grota	vale
grudar	pegar
grudento	tenaz
grugrulejar	grugrulhar
grunhir	resmuninhar
grupo	tribo
gr�nulo	gr�o
gr�	gr�o
gr�-ducal	gr�o-ducal
guapo	temido
guarda	sentinela
guarda-chuva	umbela
guarda-lou�a	louceira
guardado	vigiado
guardar	poupar
guardar-se	precautelar-se
guarir-se	reerguer-se
guarnecimento	guarni��o
guasqueiro	minguado
guerrear	oprimir
guiar	levar
guiar-se	nortear-se
guindar-se	subir
guita	negalho
gula	gulosice
gulodice	lambiscaria
guloso	lambeiro
guri	menino
g�zeo	verdoengo
g�ndara	gandra
g�nero	jaez
g�nio	temperamento
habilitar	instituir
habitado	povoado
habita��o	teto
habitual	usual
haraganar	pregui�ar
haraganear	madra�ar
harmonia	m�sica
harmonizar	recongra�ar
harmonizar-se	reconciliar-se
harpag�o	sovina
hastear	tender
haver	ter
haver-se	portar-se
hediondo	h�rrido
hemic�clico	semicircular
heran�a	patrim�nio
herm�tico	intrincado
hero�smo	hombridade
hesitante	titubante
hesitar	titubear
hidat�gero	hid�tulo
hidra�reo	hidroa�reo
hidrosfera	talassosfera
hiemal	invernoso
hier�tico	religioso
hilariar	hilarizar
hiperurbanismo	ultracorre��o
hip�crita	refalsado
hip�tese	vislumbre
hist�ria	tretas
hombridade	virtude
hominiano	hom�nido
homizio	valhacoito
homogeneizar	uniformizar
homotermal	isotermo
honestar	ornamentar
honestidade	inteireza
honestizar	nobilitar
honorabilidade	m�rito
honor�rios	sal�rio
honra	pundonor
honrar-se	prosear
hora	tempo
horda	tropel
horrendo	tetro
horripilante	temerso
horroroso	t�trico
horror�fico	horroroso
horr�fero	torvo
horr�fico	horr�vel
horr�pilo	horroroso
horr�vel	tremendo
hospedagem	pousada
hospedaria	pousada
hospitalar	nosoc�mico
hospital�rio	nosocomial
humanit�rio	humano
humildade	pobreza
humildar-se	rebaixar-se
humilda��o	rebaixamento
humilhador	humilhante
humilhante	vexante
humilhar	murchar
humilha��o	ofensa
h�bil	industrioso
h�stea	verg�ntea
ideal	idealiza��o
idealizar	sonhar
idear	inventar
idilista	quimerista
idiota	palerma
idiotifica��o	imbeciliza��o
idiotismo	zotismo
id�ia	mente
id�ntico	parecente
ignavo	manzanza
ignominiar	vituperar
ignominioso	indigno
ign�bil	miser�vel
igual	liso
igualar	respaldar
igualar-se	nivelar-se
igualizar	respaldar
igualizar-se	uniformar-se
iguaria	petisco
ilaquear	iludir
ilogia	ilogismo
iludir	velhaquear
iluso	logrado
ilustrar	ornar
imaginador	imaginante
imaginar	suscitar
imanar	imantar
imane	imenso
imaturo	prematuro
imbecil	parvo
imediato	seq�ente
imerecido	ind�bito
imerg�ncia	submers�o
iminente	impendente
imin�ncia	sobran�aria
imiscui��o	inger�ncia
imobilidade	impraticabilidade
imolador	sacrificante
imoral	obsceno
imortaliza��o	notabiliza��o
impacientar-se	irritar-se
impalpabilidade	insubstancialidade
impass�vel	inalter�vel
impedimento	obst�culo
impedir	pear
impedi��o	veda
impelente	impulsivo
impelidor	impulsor
impelir	prurir
impendente	instante
impender	pertencer
impenetrabilidade	imperceptibilidade
impensado	inopinado
imperativamente	veementemente
imperecedor	perene
imperecedouro	perdur�vel
imperfei��o	sen�o
impersistente	inconstante
impersonalidade	impessoalidade
impertinente	inoportuno
imperturb�vel	inalter�vel
impert�rrito	int�rrito
impetar	pin�ar
impetuoso	veemente
impingir	rodilhar
implicador	implicante
implicar	ter
implicativo	implicat�rio
impl�cito	subentendido
impolidez	malcriadez
imponderado	irrefletido
imponente	pretensioso
importar	introduzir
importunado	molestado
importunar	molestar
importunar-se	incomodar-se
importuna��o	irrita��o
importunice	inc�modo
importuno	inadequado
import�ncia	respeito
imposi��o	obriga��o
impregnar	induzir
impressionado	perturbado
impressionador	impressionante
impressionante	tocante
imprevistamente	inesperadamente
imprevisto	s�bito
imprimir	tipografar
improbar	reprovar
improdutivo	infrut�fero
improl�fico	inf�rtil
improvidente	negligente
improv�vel	incerto
imprud�ncia	irreflex�o
impudico	sem-vergonha
impudic�cia	sacanagem
impulso	remetimento
impureza	sujidade
impuro	incontaminado
imundo	obsceno
imunizar	mitridatizar
imut�vel	irrevog�vel
inacabado	inconcluso
inacess�vel	obstru�do
inadequado	inapropriado
inadmiss�o	rejei��o
inalar	tomar
inalheabilidade	inalienabilidade
inalhe�vel	intransfer�vel
inalter�vel	incorrutivo
inane	nugativo
inani��o	subnutri��o
inapreci�vel	inestim�vel
inapropriado	inconveniente
inatac�vel	invulner�vel
inatividade	in�rcia
inativo	sedent�rio
inato	natural
inaugural	inicial
ina��o	irresolu��o
incapaz	inv�lido
incender-se	incendiar-se
incendiar-se	referver-se
incensador	louvaminho
incensa��o	incensadela
incerto	irresoluto
incessante	incess�vel
incessibilidade	intransfer�ncia
inchar	pavonear
inchar-se	vangloriar-se
incidir	inflectir
incipiente	novo
incisivo	incisor
incitar	mordicar
incitar-se	rabiar
incita��o	provoca��o
incivilidade	rusticidade
inclemente	severo
inclinar	pender
inclinar-se	predispor-se
inclina��o	proclividade
inclusivamente	inclusive
incoer�ncia	incongruidade
incomodar	torrar
incompatibilizar	inimizar
incompreensibilidade	insondabilidade
incompreens�vel	inexplic�vel
inconfidente	insidioso
incongruente	inconveniente
inconseq�ente	inconsiderado
inconstante	vol�vel
inconst�ncia	variedade
incontest�vel	incontrovert�vel
incontrast�vel	irrefrag�vel
incontrovers�vel	inquestion�vel
incont�vel	inumeroso
inconveniente	inoportuno
incorporar	reunir
incorrer	trope�ar
incorrut�vel	reto
incrementar	ornamentar
incrementa��o	lapida��o
incubar	tra�ar
inculcar	patentizar
inculpar	recriminar
incumbir	recomendar
inc�lume	intacto
inc�modo	molestoso
indagar	procurar
indaga��o	inqu�rito
indeciso	indeliberado
indecis�o	perplex�o
indeclinabilidade	irrecusabilidade
indecorosidade	torpeza
indefectibilidade	perfectibilidade
indefect�vel	seguro
indefend�vel	indefens�vel
indefeso	inerme
indefini��o	vacilo
indenizar	remir
independente	livre
indicar	ter
indica��o	indigitamento
indiferencia��o	indiscrimina��o
indigitar	sinalizar
indignar	marfar
indignar-se	irar-se
indignidade	torpitude
indigno	refece
indig�ncia	pen�ria
indiligente	negligente
indiscernimento	indiscrimina��o
indisciplina	inobedi�ncia
indisciplinabilidade	rebeldia
indisciplinado	rebelde
indisciplinar	rebelar
indisciplinar-se	insubordinar-se
indiscreto	xereta
indiscriminado	indistinto
indiscutibilidade	inegabilidade
indissociabilidade	irredutibilidade
inditoso	infausto
individualidade	particularismo
individualmente	singularmente
individuar	privilegiar
indocilidade	rispidez
indolente	omisso
indol�ncia	madra�aria
ind�cio	toque
ind�cil	insubordin�vel
ind�stria	trabalho
inebriado	tonto
inebriar-se	toldar-se
inecess�rio	prescind�vel
inefic�cia	inefici�ncia
ineptid�o	jericada
inepto	pal�rdio
inesitante	resoluto
inesquec�vel	inolvid�vel
inevid�ncia	permist�o
inevitavelmente	necessariamente
inexato	inveraz
inexperiente	novato
inexperto	novel
inextensibilidade	restring�ncia
infact�vel	invi�vel
infal�vel	irremiss�vel
infamar	macular
infante	menineiro
infantilidade	parvulez
infeccionado	infectado
infecionado	infectado
infecionar	pestiferar
infectar	profligar
infecto	pestilencioso
infecundo	infrut�fero
infeliz	queixoso
inferior	subalterno
inferioridade	pequenez
infernal	leteu
infernar	tempestear
infernizar	quizilar
infestar	nivelar
infesto	ruinoso
infeto	podre
inficionar	malignar
infidelidade	rasteira
infiltrar	infundir
infindo	infinito
inflamar	soprar
inflar	tumescer
infletir	refletir
inflexibilidade	rudeza
inflexo	pendido
influ�ncia	jurisdi��o
informar	inteirar
infortunado	malsorteado
infrutuoso	ocioso
infundir	insuflar
infundi�a	infundice
inf�mia	vitup�rio
inf�ncia	meninez
inf�rtil	infrut�fero
ingurgitar	pejar
ing�nuo	puro
inhenho	maninelo
inibir	negar
iniciar	prelecionar
inimigo	oposto
ininterruptamente	seguidamente
ininterrupto	sucessivo
inj�ria	opr�brio
inlapidado	tosco
inocular	instilar
inopinado	subit�neo
inoportunidade	intempestividade
inquietar	vascolejar
inquieto	traquina
inquinar	poluir
inquinar-se	manchar-se
inquirideira	l�tego
inquirir	sondar
inqu�rito	interroga��o
insaci�vel	voraz
inscrever-se	matricular-se
inscri��o	lan�amento
insensatez	loucura
inserido	inserto
inserir	intercalar
inserir-se	introduzir-se
inser��o	interposi��o
insigne	renomeado
insignificante	in�til
insignific�ncia	poucachinho
insinuar	ministrar
insinuar-se	presentar-se
insipidez	mornid�o
insistente	testudo
insistir	pisar
insist�ncia	perman�ncia
insito	natural
insolente	petulante
inspetar	lealdar
inspe��o	visita
inspira��o	toque
instalar	receber
instant�neo	moment�neo
instigar	levar
instintivo	natural
instituir	nomear
instruir	lecionar
instrumentista	m�sico
instru��o	saber
insubordinar	subverter
insubordina��o	rebeli�o
insubordin�vel	rebelde
insulado	isolado
insulamento	penumbra
insular	isolar
insultar	ofender
insuper�vel	invenc�vel
insurrecionar-se	sublevar-se
insurrecto	revoltado
insurrei��o	motina��o
ins�nia	insonol�ncia
intacto	intato
integralizar	reunir
integralizar-se	inteirar-se
integralmente	inteiramente
inteirar	trancar
inteireza	totalidade
inteiro	salvo
intelig�ncia	mente
intencional	premeditado
intencionar	maquinar
intender	superintender
intensidade	veem�ncia
intensificar	recrescer
intenso	vivaz
inten��o	ten��o
interceder	ter�ar
interceptado	intercepto
interceptar	pegar
interdizer	vetar
interdi��o	proibi��o
interessar	pertencer
interesse	provento
interla�ar-se	sobra�ar-se
interlinear	sublinear
intermear	intermediar
intermedi�rio	terceiro
intermeter-se	permear-se
intern�ncio	mensageiro
interpor	intrometer
interpresar	tentar
interpretar	ter
interrogador	interrogante
interrogar	sindicar
interromper	sustar
interrup��o	travamento
intertecer	obrar
intervalo	lacuna
intricado	obscuro
intricamento	obscurecimento
intricar	intrincar
intriga	inven��o
intrigante	mexeriqueiro
intrigar	onzeneirar
introdu��o	preliminar
intrometer-se	meter-se
intrometidi�o	xereta
intrujar	velhaquear
intrujar-se	lograr-se
intruj�o	trampolineiro
intr�pido	temer�rio
intuir	ver
intumescente	tumefato
intumescer	tufar
intumescimento	turg�ncia
intumesc�ncia	turgesc�ncia
int�ctil	intang�vel
inube	l�mpido
inumanidade	sanguinol�ncia
inumano	truculento
inundar	submergir
inupto	solteiro
inusitado	inusual
inutilizar	malograr
inutilizar-se	ir-se
invas�o	tomada
invectivo	ofensivo
inventaria��o	relacionamento
inven��o	rod�zio
investida	remetida
investigar	perquirir
investir	lan�ar-se
inveterado	radicado
in�ar	invadir
in�rcia	mandriice
in�cio	origem
in�pia	pauperismo
in�til	prescind�vel
ir	perecer
ir-se	partir
iracundo	zangado
irar	irritar
irar-se	raivejar
iriante	irisante
iriar-se	matizar-se
iroso	violento
irradiar	lan�ar
irrecusabilidade	irrefragabilidade
irreflexivo	irreflexo
irreflex�o	louquice
irrefre�vel	irreprim�vel
irrenunciabilidade	irresignabilidade
irreplic�vel	irrespond�vel
irrequieto	pressuroso
irresolu��o	perplexidez
irretoc�vel	lapidar
irritadi�o	violento
irritador	irritativo
irritar	torrar
irritar-se	repruir-se
irrita��o	nervosidade
isentar-se	livrar-se
islamismo	mu�ulmanismo
isoclinal	isoclino
isocrom�tico	is�cromo
isof�nico	is�fono
isolado	solit�rio
isolar	separar
isolar-se	retrair-se
isom�rfico	isomorfo
italianoman�aco	ital�mano
iterar	voltar
jactanciar-se	louvar-se
jactancioso	presun�oso
jactante	loroteiro
jactar-se	triunfar
jacular	vibrar
jaezar	ornar
jaldinino	jalne
jangalamaste	zanga-burrinha
janotar	janotear
janotear	pimponar
janotear-se	peralvilhar-se
janotice	tafularia
jaruru	macamb�zio
jatancioso	presumido
jatante	vanglorioso
jatar-se	picar-se
jat�ncia	orgulho
jazida	veio
jeca	matuto
jigajoga	lud�brio
jirau	sobreloja
jogada	lance
jogado	prostrado
jogar	projetar
jornada	viajada
jorrar	manar
jovem	mancebo
jovializar	letificar
jubilar	recrear
jubila��o	regalo
jubiloso	jucundo
judiar	magoar
jugo	vassalagem
jugular	sufocar
julgar	olhar
julgar-se	ter-se
junco	verdasca
junta	par
junto	ligado
jura	praga
juramento	promessa
jurar	maldi�oar
justar	pactuar
justificativa	satisfa��o
juvenilidade	juventude
juventa	juventude
ju�zo	reflex�o
j�vene	mo�o
labor	lavor
laborioso	molesto
labrego	lapuz
labutar	trabalhar
lacaio	volante
lacerar	magoar
laconizar	substanciar
lacrimal	lagrimal
lac�nico	preciso
ladainha	lengalenga
ladear	rodear
ladeira	repiquete
ladeirame	ladeiramento
ladino	tacanho
ladroagem	trama
laivo	vislumbre
lamaceira	lameiro
lama�al	poceir�o
lambanceiro	lambeta
lambareiro	lambaz
lamber	tocar
lambidela	lambuja
lamborada	lategada
lamb�o	paspalh�o
lameirento	pantanoso
lameiroso	lutulento
lameir�o	loda�al
lamelar	laminar
lamenta��o	lamento
lamento	murm�rio
lamentoso	magoado
lampadejar	lucilar
lampad�rio	lustre
lamuriante	lamuriento
lamuriar	prantear
lamuriar-se	prantear-se
lam�ria	ulo
languescer	prostrar
languidez	moleza
lanhar	verrumar
lanhar-se	lesionar-se
lanoso	lanudo
lantejoilar	lantejoular
lantejoulante	lentejoilante
lan�adura	remesso
lan�ar	projetar
lan�ar-se	saltar
lapidar	substanciado
lapidificar	petrificar
lapidifica��o	petrifica��o
larapiar	subtrair
largada	sal
largar-se	refugir
lasca	talisca
lasc�via	lux�ria
lassear	laxar
lastimar-se	vagir
lastrar	semear
latejar	later
latejo	pulo
lateral	travesso
laticinoso	leitoso
latir	vociferar
lavandaria	tinturaria
lavoira	lavragem
lavor	trabalho
lavrar	rasourar
laxar	safar
laxa��o	suaviza��o
lealdar	visitar
legal	l�cito
legisperito	legista
legitimador	legitimativo
leg�timo	verdadeiro
lei	ordem
leigo	profano
leit�o	porquinho
lembran�a	marca
lembrar	sair
lembrar-se	relembrar-se
leme	mando
lenda	mitologia
lengalenga	litania
lenificar	lenir
lenitivo	refrig�rio
lentejar	transcoar
lentejar-se	orvalhar-se
lentescente	pegajento
lentescer	regar
lenticular	lentiforme
lentigo	ovo-de-peru
lento	pesado
leproso	macutena
lerdo	tardo
lesar-se	marcar-se
lesma	molenga
lesto	presto
letal	let�fico
letificar	medrar
levado	traquina
levantador	revoltador
levantamento	motina��o
levantar	propor
levantar-se	virar
levante	sedi��o
levar	portar
leve	ligeiro
levogiro	sinistrogiro
liame	n�
liba��o	libame
libente	prazenteiro
liberdade	permiss�o
libertador	redimidor
libertar	tirar
libidinagem	vol�pia
libidinosidade	sensualidade
liceal	liceano
liceidade	licitude
licenciosidade	trip�dio
licencioso	obsceno
lidar	mexer
ligar-se	unificar-se
ligeiro	veloz
limar	policiar
limiar	origem
limitado	restringido
limitar	reduzir
limitativo	restringente
limita��o	restri��o
limite	linda
limn�tico	l�mnico
limo	vasa
limpar	rastelar
limpar-se	livrar-se
linguajar	parlar
linguarado	linguarudo
linguarejar	palrear
linha	raia
liquidado	l�quido
liquida��o	quita��o
liquidez	liq�idez
liquidificante	liq�idificante
liq�idante	liquidat�rio
liq�idar	perfazer
liso	macio
lisonjaria	subservi�ncia
lisonjeador	louvaminheiro
lisonjear	satisfazer
lisonjear-se	repastar-se
lisura	suavidade
litigiar	pleitear
litig�vel	litigioso
livrar	preservar
livrar-se	pisgar-se
livre	safo
lixento	porco
li��o	repreens�o
loba	samarra
lobrigar	vislumbrar
localista	lugareiro
loda�al	p�ntano
lodeira	lodeiro
logrador	trapaceador
lograr	sofismar
logro	messe
longamira	�culo-de-alcance
longitude	lonjura
longo	prolixo
long�nimo	magn�nimo
long�quo	p�stero
loquaz	mult�loquo
lorota	poeira
lorpa	pal�rdio
lotar	tomar
louco	tresloucado
lourecer	lourejar
louvar-se	repousar
louva��o	magnifica��o
lucilar	prefulgir
luciluzir	raiar
luciv�u	p�ra-luz
lucrar	usufruir
ludibriar	pantomimar
lufa	rabanada
lugarejo	s�tio
lumeeira	lustre
luniforme	lunulado
lunulado	lunular
lusco	vesgo
lusitanizar	portugalizar
lusitanof�lico	lusof�lico
lusque-fusque	meia-tinta
lustrar	palpitar
lus�ada	lusitano
luta	pend�ncia
lutar	questionar
luxo	riqueza
luxurioso	obsceno
luz	resplend�ncia
luziluzir	pestanejar
luzimento	refulg�ncia
luzir	prefulgir
l�bia	loquacidade
l�tego	relho
l�teo	laticinoso
l�sbica	mulher-homem
l�vido	pl�mbeo
l�gico	producente
l�brego	t�trico
l�cido	n�tido
macabro	t�trico
macacal	simiesco
macamb�zio	mazorro
macaquear	repetir
macera��o	tortura
machacaz	machucho
macho	masculino
machucar	vulnerar
machucar-se	susceptibilizar-se
machucho	velhaco
maciar	mitigar
macieza	moleza
maconha	pango
macotena	morf�tico
madeixa	mecha
madescente	�mido
madornento	sonolento
madracear	suciar
madra�ar	passarinhar
madra�o	zopeiro
madurar	subtilizar
madurecer	subtilizar
magistral	perfeito
magnanimidade	nobreza
magnata	senhora�o
magnificente	triunfante
magnitude	pujan�a
magoado	pisado
magoar	maltratar
magoar-se	sentir-se
magote	ranchada
magrete	magru�o
magricela	magriz
magri�o	magrizela
mais	restante
majestoso	venerando
majest�tico	respeit�vel
mal-arrumado	mal-enjorcado
mal-aventurado	malfeliz
mal-educado	mazorro
mal-ensinado	mazorral
mal-entrajado	malroupido
malandrar	vagabundar
malaxar	matar
malconformado	malproporcionado
malcontente	triste
maldade	malignidade
maldadoso	malicioso
maldito	triste
maleabilidade	maneabilidade
malear	minorar
maleficiar	mandingar
malef�cio	preju�zo
maleta	malote
malfeliz	malventuroso
malgastar	prodigar
malhar	vasconcear
malicioso	travesso
malignar	subverter
malignidade	perversidade
maligno	n�xio
malposto	malvestido
malquerido	odiado
malquisto	malvisto
maltrapilho	trapalh�o
malvado	nefando
malversador	malversor
mal�fico	pernicioso
mal�fero	mals�o
mama	teta
mamant�o	mam�o
mamar	velhacar
manada	s�cia
manar	vir
mancar	manquitolar
manchar	poluir
mancheia	punhado
manco	rombo
mancomunagem	tram�ia
mandar	tra�ar
mandinga	salga��o
mando	r�dea
mandriar	mandrionar
mandri�o	zopo
manear	superintender
maneira	t�cnica
maneiroso	namorado
manejo	manuseamento
mangar	pilheriar
manga��o	moca
manha	savoir-faire
mania	v�cio
maniatado	manietado
manicurto	mesquinho
manifestar	mencionar
manifesto	�bvio
manino	pequenino
manivelar	ocupar-se
manja	tempo-ser�
manjadoura	manjedoura
manj�vel	vesco
manobra	truque
mantear	nausear
manter-se	nutrir-se
mante�do	mantido
mantilha	v�u
mantimento	reten��o
manusea��o	manuseamento
manzanza	ocioso
man�	toleir�o
maquete	modelo
maquilar-se	pintar-se
maranhar	perturbar
marasmado	marasm�tico
maravilhar	surpreender
maravilhoso	mir�fico
marca	vest�gio
marcador	placar
marcha	processo
marchar	progredir
marejar	porejar
margem	oportunidade
marginal	rip�cola
marinheiro	mar�timo
mariola	maroto
mariposar	mariposear
marmelada	velhacaria
marm�reo	marmorino
maroto	ribaldo
marretar	tarear
marroada	porretada
marroaz	teimoso
martelar	martelejar
martirizar-se	remoer-se
mart�rio	sofrimento
mar�timo	naval
mascar	murmurar
mascarar	rebu�ar
mascatea��o	mascateagem
mascotar	mastigar
masculinizar	virilizar
massacrante	secador
massacrar	modornar
massamorda	miscel�nea
masticat�rio	mastigat�rio
mastigar	zavar
masturba��o	onanismo
matagal	selva
matan�a	varredoura
matar	trucidar
matematicidade	precis�o
materialidade	mundanidade
materializar-se	objetivar-se
matina	matinada
matinar	remorder
matizado	mesclado
mato	ro�a
matriz	seio
matulagem	sarandagem
matutar	meditar
mat�ria	tema
mau	m�sero
mav�rcio	mav�rtico
mazanza	zopeiro
mazelar	melindrar
mazorro	napeiro
ma�a	toco
ma�ada	tacada
ma�ador	paulificante
ma�ar-se	nausear-se
mealha	ninharia
mecha	pavio
mediador	medianeiro
mediania	mediocridade
medicar-se	tratar-se
medidor	rel�gio
mediocridade	regularidade
medir	proporcionar
meditabundo	meditativo
meditativo	penseroso
medrar	pular
medroso	timorato
medusa	xaveco
mef�tico	pestilencial
meigamente	mimosamente
meigo	simp�tico
melanc�lico	tristonho
melanoxanto	melaxanto
melhor	prefer�vel
melhorar	serenar
melindrar	vulnerar
melindroso	puro
melodia	m�sica
melodiar	melodizar
memorando	memoroso
memora��o	recorda��o
memor�vel	memorial
mencionar	pronunciar
meneamento	oscila��o
menear	sacolejar
meninota	molecota
meninote	mocinho
menoscabar	rebaixar
menosprezar	sobpor
menospre�ar	pospor
mensalidade	mesada
mentido	mentiroso
mentir	ocultar
mentira	xod�
mentiroso	potoqueiro
mercadejar	trafegar
mercanciar	negociar
merecimento	m�rito
meretriciar-se	prostituir-se
meretriz	mulher-do-fandango
mero	s�
mesclar-se	promiscuir-se
mesmo	pr�prio
mesquinhez	pequenez
mesquinheza	minimidade
mesquinho	pelintra
mestre	preletor
mesurado	reverenciador
mesurar-se	refrear-se
metamorfosear-se	mudar-se
meter	sepultar
meticuloso	p�vido
meton�mia	transnomina��o
mexer	saber
mica	migalha
miga	rebotalho
migado	picado
migalha	migalho
milagroso	tremendo
milenar	milen�rio
milenarista	quiliasta
milen�rio	mil�nio
milit�ncia	oposi��o
mina	tesoiro
minar	surdir
mindinho	m�nimo
minguado	prec�rio
minimidade	pouquidade
ministrar	soprar
minuir-se	moderar-se
min�cia	pormenor
mira	objeto
mirar-se	olhar-se
mirrado	torrado
misantropia	taciturnidade
misantropo	solit�rio
misericordioso	pio
miser�vel	sovina
mission�rio	padre
mistela	mistif�rio
misterioso	obscuro
mistificar	velhacar
mistif�rio	mix�rdia
misto	mistura
mis�ria	sovinice
mitene	punhete
miudeza	poucochinho
mi��a	miu�alha
mobilizar	soltar
mocamau	quilombola
modelo	tipo
moderado	temperado
moderador	moderat�rio
moderar	suavizar
modera��o	prud�ncia
modernizar	renovar
modicar	sopitar
modornar	nausear
modulado	musical
mofatra	trapa�a
mogangueiro	munganguento
moganguice	monada
moiro	mourisco
molambo	trapo
moldurar	ornamentar
molecada	pirralhada
moleir�o	zorreiro
molenga	zorreiro
molengo	pachola
moleng�o	molengo
molestado	ofendido
molestar	obsidiar
molestar-se	quizilar-se
molesto	secador
moleza	suavidade
molha	molhadura
molhadela	sobrepaga
molhar-se	orvalhar-se
molhe-molhe	zimbro
monja	professa
montanh�s	montano
montar	situar
montear	superpor
mont�o	ruma
mont�s	montesino
monumental	rico
mon�stico	monjal
morada	pousada
moradia	pousada
mordedura	trincada
morder	zavar
mordida	mordidela
mordiscar	soprar
morfenho	rouquenho
morf�ico	morf�tico
moribundo	morredi�o
morrer	rematar
morr�o	pevide
mortandade	varredoira
morte	sobrevida
mortificar-se	penalizar-se
mortinatalidade	natimortalidade
mosa�sta	tessel�rio
mosleme	mu�ulmano
mosl�m	moslim
mostrar	pontar
mostrar-se	repontar
motejar	ridicularizar
motinar	revolver
motivar	ocasionar
mourejar	trafegar
mouro	sarraceno
mudadi�o	vol�til
mudan�a	muta��o
mudar	transubstanciar
mudar-se	trocar-se
muito	sobreguisa
mulher-de-m�-nota	prostituta
mulher-homem	mulher-macho
mulher-perdida	prostitu�da
multiface	multifacetado
multiforme	prot�ico
multipontuado	salpintado
mundificar	purgar
munganguento	trejeiteiro
mungida	ordenha��o
mungir	ordenhar
munheca	punho
munheca�o	tabefe
municionar	munir
munir	sortir
murchar	secar
murcho	ressequido
murmulhar	rumorejar
murmurar	rezingar
murmurejar	rugitar
muscoso	musgoso
musicalidade	unisson�ncia
mutabilidade	ressaca
mutuar	permutar
muxir�o	muxirum
m�gico	vat�dico
m�ximo	tope
m�dio	meio
m�lico	sonoro
m�todo	regime
m�mico	pantomimeiro
m�sero	perverso
m�tilo	seccionado
nadar	tranar
namoradeiro	requestador
narcotizar	paulificar
narrado	referido
nateirado	natento
nativo	p�trio
natural	origin�rio
naturalidade	origem
nauseante	nauseoso
neblina	nevoa�a
neblinar	pingar
nebrina	nevoeiro
nebulado	nuvioso
nebulento	nevoento
nebulizador	vaporizador
necessidade	nudez
nefando	r�probo
negar-se	recusar-se
nega��o	negativa
neglig�ncia	ronceirismo
negociado	permutado
negrejar	pretejar
negro	tenebroso
neg�cio	ocupa��o
nenho	tacanho
nerval	nevrino
nervoso	nevrino
netuniano	net�nio
nevoar-se	obscurecer-se
nimbo	resplendor
ninar	rolar
nitente	resplendente
nocivo	pernicioso
noctambulante	noct�vago
noct�mbulo	son�mbulo
noitada	noutada
noivos	rec�m-casados
nomenclatura	rela��o
nonada	trica
normal	perpendicular
nota	observa��o
notar	verberar
noticiar	reportar
notificar	participar
noute	v�u
novato	novo
novo	segundo
nublar-se	turvejar-se
nugativo	v�o
nulo	rid�culo
nuper-falecido	rec�m-finado
nutrimental	nutritivo
nutrit�cio	substancioso
nuvem	sombra
nuvioso	obumbrado
n�o	negativa
n�rveo	nervino
n�tido	resplandecente
obcecar	obumbrar
obceca��o	paix�o
obedecer	trilhar
objetar	remenicar
objetiva��o	resolu��o
objetivo	objeto
obl�quo	transversal
obnubilar	ofuscar
obnubilar-se	obscurecer-se
obrigar	superar
obscurecer-se	perder-se
obscuro	trevoso
obsedante	obsediante
obsediar	rascar
obsequiador	sol�cito
obseq�ente	submisso
observar	tirar
obsidiar	rascar
obstante	obstativo
obstar	travar
obstinado	persistente
obstina��o	teimosia
obstru��o	remora
obst�culo	transtorno
obtemperar	submeter-se
obtestar	provocar
ocasional	ocasion�rio
ocasionar	provocar
ocasionar-se	sobrechegar
ocidente	oeste
ociosidade	pregui�a
ocioso	ronceiro
ocorrer	passar-se
octogonal	oct�gono
ocultar	sonegar
oculto	sobrenatural
ocupar-se	rasar-se
ocupa��o	of�cio
odorante	perfumado
odoro	perfumado
odor�fero	perfumado
ofender	postergar
ofensivo	prejudicial
ofuscamento	turvamento
oirejar	ourar
ojerizar	peguinhar
olaria	tijolaria
oleoso	untuoso
olhada	olhadela
olhar	saber
olhizaino	z�imbo
olorado	perfumoso
olorante	perfumoso
ominar	profetar
omissor	omiss�rio
omnissapiente	on�scio
omn�voro	pol�fago
onda	turba
ondar	ondear
ondeante	ondulat�rio
ondulado	onduloso
onipresente	ub�quo
onzeneiro	usureiro
opar-se	tufar-se
operar	proceder
operativo	produtivo
opiniativo	problem�tico
opinioso	porfioso
opini�tico	tungador
oportuno	prop�cio
oposi��o	tope
opress�o	viol�ncia
oprimir	urgir
opulentar	reputar
opulento	pomposo
op�paro	opulento
ordenar	regularizar
orfanar	tirar
organiza��o	sociedade
orienta��o	rota
orif�cio	v�o
originar	produzir
orla	tira
ornar	tecer
ornear	ornejar
oscilar	trepidar
oscila��o	vibra��o
ostens�o	vaidade
ostens�vel	vis�vel
ostens�rio	patente
ostenta��o	vaidade
ostentoso	ufano
ot�rio	trouxa
ourar	ourejar
ouropel	pechisbeque
ourudo	pecunioso
outar	peneirar
ouvidor	ouvinte
ovado	ovalado
oval	ovalar
overdose	superdose
ovniol�gico	ufol�gico
ovniomania	ufomania
oxigenar	vigorar
ozonado	ozonizado
o�sico	oasino
pacato	tranq�ilo
pachorrento	vagaroso
pacificar	sedar
pacificar-se	quietar-se
pactuar	temporizar
pact�cio	pactual
pac�fico	sossegado
pac�vio	simpl�rio
padecer	tolerar
padroeiro	protetor
paga	remunera��o
pagamento	sal�rio
paganizador	paganizante
pagar-se	reparar-se
pagodear	rosetar
painel	palco
pairar	trepidar
paisano	patr�cio
palanfr�rio	parlenga
palatal	palatinal
palavrear	palrar
palavr�rio	parlenda
palerma	palon�o
palestrar	tratar
palha�o	tru�o
palhetar	trotear
palhetear	zombetear
palmar	roubar
palmear	tirar
palon�o	tolo
palpabilidade	tangibilidade
palpar	tocar
palpa��o	tateamento
palpitar	perquirir
palrar	tartarear
palrear	revelar
palrice	parolagem
palustre	pantanoso
pal�dico	paludoso
pal�rdio	patola
pampanoso	pamp�neo
pancada	pulsa��o
pandeireiro	pandeirista
pandilha	pandilheiro
paniguado	protegido
pano	tecido
panorama	perspetiva
pantalha	tapa-luz
pantear	zombar
papa-fina	saboroso
papagaio	quadrado
papelejo	papelucho
papo	saco
par	parelha
parada	susta��o
parado	suspenso
paralisar	torpecer
paralisa��o	travamento
paramentar	vestir
parasita	sanguessuga
parasitar	sugar
parasita��o	parasitismo
parasitear	sugar
parasito	sabujo
parcela	por��o
parco	poupado
parda�o	ru�o
pardieiro	tapera
parentesco	sanguinidade
paridade	similitude
parodiador	parodista
parolar	tarelar
parolear	tartarear
parte	peda�o
participador	part�cipe
particularmente	privadamente
partimento	reparti��o
partir-se	remoer-se
parvajola	z�ngano
parvo	tolo
parvoeirar	parvoejar
parvuleza	puerilidade
pascentar	regalar
pascer	retoi�ar
passadio	vivenda
passar	romper
passear	universalizar
passeio	volta
pastar	retou�ar
pastejar	retoi�ar
pastio	pasto
patente	vis�vel
patentear	revelar
pateta	patola
patetear	pejar-se
patifaria	velhacaria
patife	vergalho
patina��o	patinagem
patola	tolo
patranha	tretas
patriarcal	vener�vel
patrono	protetor
pausar	remorar
pautar	recensear
pavesar-se	vangloriar-se
paz	repoiso
paziguar	sedar
pecunioso	rico
pedacinho	tudo-nada
pedido	s�plica
pedigonho	pedinch�o
pedir	vindicar
pegadi�o	tenaz
pegado	pr�ximo
pegajoso	tenaz
pegar	unir-se
peguento	visguento
peguilha	peguilho
peita	suborno
pejado	vergonhoso
pejamento	vexame
pejar	travar
pelar	rapinar
peleja	pr�lio
pelejador	rixoso
pelintra	som�tico
peloso	peludo
pena	sofrimento
penado	sofredor
penalizar	pungir
pendente	penduricalho
pender	reclinar
pendor	rampa
pend�ncia	refrega
peneirar	sururucar
penetrar	pescar
penhorar	seq�estrar
penit�ncia	tortura
pensar	refletir
pension�rio	pensionista
pequeninote	pequenitote
pequeno	pequerrucho
peraltar	trasguear
peraltear	traquinar
peraltice	tafularia
peralvilhice	tafulice
perambulagem	vadiagem
perceber-se	reconhecer-se
percentagem	porcentagem
percevejo	tacha
percorrer	perscrutar
perda	traspassamento
perder-se	so�obrar
perdido	submergido
peregrino	vindi�o
perene	porfioso
perfazer	vencer
perfei�oar-se	requintar-se
perfei��o	precis�o
pergurar-se	transfixar-se
pericote	pitote
perito	pr�tico
peri�dico	r�tmico
perlar	perolizar
permitir	suportar
permutador	trocador
permuta��o	troca
pername	pern�o
perna�a	pern�o
perna�o	pername
pernegudo	pernudo
pernejar	transpor
perquiri��o	procura
persecu��o	persegui��o
perseguidor	seguidor
perseguir	tempestuar
perseverante	persistente
perseveran�a	persist�ncia
perseverar	persistir
persigal	presepe
persistir	ter-se
personalizar	pessoalizar
perspicaz	sagaz
perspirar	vislumbrar
persuasivo	suas�rio
persuas�vel	ponderoso
pertinaz	porfiado
pertinente	referente
pertin�cia	recalcitra��o
pertransir	transir
pertucho	portucho
perturbador	perturbante
perturbar	torvar
peruar	requestar
pervagar	vagar
pervencer	vencer
pesa-pap�is	peso
pesado	tenso
pesar	pungimento
pesca	piscicaptura
pescar	tomar
pestanear	pestanejar
pestanejar	piscar
pesteado	pest�fero
pestear	ulcerar
petema	pitura
petima	petume
petimetre	pimp�o
peti��o	suplica��o
petrechar-se	premunir-se
petum	tabaco
petume	tabaco
pe�a	pirra�a
piar	pipilar
picar	requeimar
pico	zingamocho
pict�rico	pitoresco
picuetada	pulha
picum�	tisne
pife-pafe	pif-paf
pigmentar	tingir
pilha	ruma
pilhador	saqueador
pilhar	saquear
pilheriar	rir
pimpar	pimponear
pimpolhar	proliferar
pimponice	rebolaria
pimp�o	s�cio
pindobal	pindoval
pinga	pingo
pingar	pingotear
pingo	salpico
pingotear	transcoar
pintar	retratar
pin�culo	zingamocho
pin�ar	projetar
pio	religioso
piorra	pitorra
pipilar	regorjear
pipitar	taralhar
pirueta	reviravolta
pisa	surra
piscar	reluzir
pitada	ponta
pit�nico	vat�dico
piv�	promotor
pixote	principiante
placar	retundir
placidamente	tranq�ilamente
plaga	terra
planalto	rech�o
planifica��o	programa��o
planta	tra�ado
plantar-se	sentar-se
planta��o	plantio
plastr�o	plastrom
plausivelmente	racionalmente
plebeu	ru�o
pleiteante	pleitista
pleito	sabatina
pleon�stico	redundante
pl�cito	prazimento
poder	suportar
poderoso	soberano
podrid�o	podriqueira
poeirento	polvoroso
poente	p�r-do-sol
poetificar	versar
poitar	puitar
policiar	refrear
polposo	toroso
polui��o	xila
polvilhar	salpicar
pomada	proa
pombear	pombeirar
pompear	pracear
pondera��o	siso
ponta	v�rtice
pontado	ponteado
ponteado	pontoado
ponto	termo
pontual	religioso
ponxir�o	putir�o
popocar	trapejar
popularidade	publicidade
popularizar	propalar
porcentagem	teor
porejar	revir
porfiado	porfiador
porfiar	renitir
porfioso	renitente
porn�ia	pornografia
porrete	trocho
porta-seios	sustenta-seios
portador	vetor
porte	vivenda
porvindouro	venturo
pospasto	sobremesa
pospontar	ufanar-se
possessor	possuidor
postemar-se	torvar-se
postergar	sotopor
posterga��o	procrastina��o
posterior	subseq�ente
postulado	rogado
potencializar	vigorar
potra	sobranceria
pot�ncia	robustid�o
poupan�a	sovinaria
povo	vulgo
pragm�tica	protocolo
pranto	vagido
praxe	usan�a
prazer	satisfa��o
preacada	verdascada
preambular	proemiar
preanunciar	prognosticar
precatadamente	prevenidamente
precatar-se	precautelar-se
precautelar-se	precaver-se
precau��o	preven��o
precavido	prudente
preca��o	s�plica
preceituar	prescrever
precinto	zona
precipitar-se	projetar-se
preciso	sint�tico
precogita��o	prepara��o
predefini��o	profecia
predicador	pregador
predica��o	serm�o
predispon�ncia	veia
predisposi��o	veia
predito	prognosticado
predizer	prenunciar
predi��o	prognostica��o
predomina��o	supremacia
predomin�ncia	predom�nio
preexcelso	sobreexcelente
prefa��o	prel�dio
preferir	prepor
prefulgir	relumear
prega	ruga
pregar	tracionar
pregoar	proclamar
preguear	repanhar
preguicento	zorreiro
pregui�oso	ronceiro
prelada	prioresa
preliar	reixar
preludiar	prologar
preluzir	relumar
premeditado	proposital
premir	prensar
premunir-se	prevenir-se
prender	represar
prender-se	sujeitar-se
prenuncia��o	progn�stico
preparado	prestes
preparar	urdir
preponder�ncia	supremacia
prescind�vel	superv�cuo
prescri��o	provis�o
presentar	semelhar
preservar	salvar
preservar-se	salvaguardar-se
presidir	zelar
pressagiar	prognosticar
pressentir	profetar
pressuposto	pretexto
press�gio	profecia
prestacionar	subvencionar
prestadio	prestante
prestamente	prestemente
prestativo	sol�cito
presta��o	prestamento
preste	prestes
prestes	veloz
prest�vel	serv�vel
presumir	vislumbrar
presun�oso	vaidoso
presun��o	pretens�o
pretender	visar
pretenso	suposto
pretermitir	rejeitar
pret�rito	transcurso
prevarica��o	salacidade
prevenir	resguardar
prevenir-se	vigilar-se
prever	surpresar
previs�o	progn�stico
prezar-se	ufanar-se
pre�mbulo	prel�dio
pre�o	vara
pre�nsil	preensor
primar	ressaltar
primaveral	primaveril
primeiramente	primeiro
primordial	substancial
principesco	soberbo
privan�a	valimento
privar	trosquiar
privativo	restrito
privilegiado	�nico
privil�gio	vantagem
probat�rio	provat�rio
proced�ncia	s�bole
procela	tormenta
processal	processivo
processo	t�cnica
procrastina��o	retarde
procriar	prolificar
procurar	requestar
prodigioso	tremendo
produtividade	rendimento
produtivo	rico
produto	rebento
produzir-se	sobrevir
proemin�ncia	relevo
profanar	trespassar
profecia	vatic�nio
proferimento	pronuncia��o
professar	ter
profetar	saber
profetizar	saber
profliga��o	retrocesso
profundar	recorrer
profus�o	superabund�ncia
prof�cuo	proveitoso
progenitura	s�bole
progress�o	progresso
projetar	propulsar
proje��o	sali�ncia
prolongar-se	prorrogar-se
prolonga��o	prolongamento
prol�quio	refr�o
promover	suscitar
pronto	rematado
propagar-se	transpirar
propaga��o	sementeira
propina	xixica
propor	sugerir
propriet�ria	senhora
prop�sito	vista
prorrogar-se	protrair-se
prosador	prosista
prosaico	pros�stico
proscrever	sentenciar
prosear	triunfar
prostituir	rebaixar
pros�pia	rebolaria
proteger-se	velar-se
protela��o	retarde
protraimento	retarde
prova	testemunho
proveito	r�dito
provento	vantagem
proventos	vantagem
prover	refazer
providenciar	socorrer
provimento	tento
provir	vir
provisional	tempor�neo
provocante	sedutor
provocat�rio	reptador
proximamente	recentemente
prudente	sensato
pr�tica	pr�xis
pr�-escolar	pr�-prim�rio
pr�stimo	proveito
pr�spero	venturoso
pua	torno
pubente	pubescente
publicar	solhar
pudente	recatado
pudico	recatado
pugnador	pugnaz
pujante	vigoroso
pujan�a	robustid�o
pulgoso	pulguento
pulha	reles
pundonoroso	reto
puni��o	vara
pun�ceo	rubicundo
purga	purgante
purgar-se	reabilitar-se
purificar	virginizar
purpurejante	vermelho
purpurejar	vermelhejar
putir�o	putirum
putrefato	putrefeito
putrefeito	p�trido
puxar	tender
pux�o	puxavante
p�vido	t�mido
p�ndega	tro�a
p�-de-meia	reservas
p�lago	precip�cio
p�rfido	trai�oeiro
p�rvio	transit�vel
p�lo	penugem
p�caro	solerte
p�fio	torpe
p�r	submeter
quadrante	setor
quadrig�meo	qu�druplo
quadripartido	quadripartito
quadriss�labo	tetrass�labo
qualidade	superioridade
quebra	quebrantamento
quebra-luz	refletidor
quebrado	violentado
quebramento	viola��o
quebrar	saracotear
queda	tombo
queimar	requeimar
queixa	ressentimento
querela	quiz�lia
querelador	quereloso
querenar	recuperar
queren�a	quer�ncia
queren�oso	simp�tico
querer	vontade
quietar	serenar
quieteza	tranq�ilidade
quietismo	requietude
quietitude	repouso
quietude	suavidade
quilatar	tomar
quimbembes	xurumbambos
quimera	vaguea��o
quindim	tagat�
quinta	rancho
quitador	quitante
quitar-se	separar-se
quitute	tagat�
quizila	rota
qu�chua	qu�chua
rabear	vanguejar
rabeira	viso
rabo	rasto
rachadura	trinca
rachar	tundar
racioc�nio	raz�o
racioneiro	ra�oeiro
radiar	raiar
radical	radicalista
radicela	raigota
radiemissor	radiotransmissor
radioso	rebrilhante
radi�grafo	radiologista
rafaelista	rafaelita
raia	risca
raivento	zangadi�o
ralha��o	ralho
ralo	ronqueira
rama	ramalheira
ramelento	remelento
rameloso	remel�o
ramerrame	rotineira
ranchinho	rancho
ranger	rechinar
ran�o	ressaibo
rapace	rapinante
rapar	unhar
rapidez	velocidade
rapinador	rapinante
rapinhar	tirar
raposeira	soneca
raposia	viveza
rasa	rasoira
rasar	rasoirar
rasar-se	tomar-se
rascar	unhar
rasgar	transpor
raspado	sumido
raspe	repreens�o
rasto	rieira
rateio	reparti��o
razoar	sustentar
reabastecimento	refornecimento
reabilitar	redimir
reabilitar-se	remir-se
reacender	reanimar
readquirir	resgatar
reafirma��o	sustenta��o
realizar-se	sair
reanimar	renovar
reaprendizado	reaprendizagem
reati�ar	reespertar
reaver	recobrar
rebaixar	setear
rebate	sentimento
rebater	sacudir
rebelado	revoltado
rebelde	revoltoso
rebenque	vergasta
rebentar	vir
rebenta��o	romper
reboante	retumbante
rebocadura	reboque
reboco	revestimento
rebolir-se	sacudir-se
rebordosa	r�cipe
rebotar	recha�ar
rebramar	ressoar
rebrilhante	resplandente
rebrilhar	resplender
rebrilhoso	resplandente
rebusca	rebusco
rebu�ar	velar
rebu�o	refolhamento
recacau	regal�rio
recaimento	reincid�ncia
recalcitrar	repostar
recalcitra��o	tineta
recalcitr�ncia	reincid�ncia
recamar	vestir
recatado	refletivo
recato	retraimento
receita	rendimento
recept�culo	vasilha
recesso	retiro
recidivo	reincidente
reciprocar-se	revezar-se
reclamar	vindicar
recobramento	recobro
recobrir	resguardar
recocto	recozido
recolher	respigar
recolocar	repor
recome�ar	voltar
recompensar	remir
recompor	regenerar
reconcentra��o	uni�o
reconciliar	recongra�ar
recondicionar	reparar
reconfortar	reconstituir
recongra�ar	temperar
reconhecer	retribuir
reconstituir	reparar
reconstru�do	reedificado
reconvir	retomar
recopilar	resumir
recorda��o	reminisc�ncia
recortado	rendilhado
recrescer	restar
recriminar	repreender
recua	recuamento
recuamento	recuo
recuar	refugir
recuperar	renovar
recuperar-se	reparar-se
recuperativo	recuperat�rio
recupera��o	restaura��o
recurso	socorro
rec�m-nado	rec�m-nascido
redarg�ir	retorquir
redepositar	repor
redimir	reembolsar
redistribuir	remanejar
redivivo	ressurrecto
redomoinho	remoinho
redondamente	redondo
redondeza	rotundidade
redundar	sair
redutivo	redutor
redut�vel	reduz�vel
reduzir	sujeitar
reduzir-se	sujeitar-se
reedificar	reerigir
reeditar	reestampar
reencetar	retravar
refazer	remir
refece	soez
refestelado	repimpado
refinadura	refinamento
refletido	sisudo
refletir	revelar
reflexivo	sensato
reflorescer	renascer
reflorir	renascer
refocilar	restabelecer
refocilar-se	vadiar
refolhamento	rufo
reformar	restabelecer
refor�o	revestimento
refrativo	refringente
refreado	retido
refreamento	repress�o
refrear	represar
refrear-se	vencer-se
refrescamento	suprimento
refresco	refrigerante
refre�vel	sofre�vel
refrigerante	refrig�rio
refrulho	rumorejo
refulg�ncia	rutil�ncia
refundir	retificar
refundir-se	reunir-se
rega	regadura
regalia	vantagem
regalo	regozijo
regatear	vilificar
regateiro	vanglorioso
reger	regular
registar	titular
regorjear	trinar
regougar	rosnar
regozijar-se	ufanar-se
regresso	retorno
regueira	riacho
regueiro	veio
reguingueiro	rezingueiro
regularidade	uniformidade
reina��o	safadice
reinterrogar	reperguntar
rejeitado	repelido
rejeitar	revessar
rejuvenescer	renascer
relacionar	unir
relampear	relampejar
relar	ro�ar
relembrar	revivescer
reles	s�rdido
relevar-se	sobrelevar-se
religi�o	valores
relinchar	trinir
relumar	tremer
relumear	tremular
remador	r�mige
remanso	sossego
remar	sobrenadar
rematado	ultimado
remediar	sanar
remelexo	requebro
rememorar	ver
remenicar	ripostar
remeter	saltear
remeter-se	reportar-se
remexer	remover
reminisc�ncia	retentiva
remir	restituir
remi��o	salva��o
remodelagem	remodelamento
remoela	trote
remontar	restabelecer
remordaz	remordente
remover	transferir
remo�ante	remo�ativo
remunerativo	remunerat�rio
renascer	renovar-se
renit�ncia	tineta
renovar	reverdecer
renovar-se	revigorar-se
renunciar	resignar
repanhar	tomar
reparar	sanar
reparti��o	se��o
repelir	vastar
repenicar	tanger
repercutir	ressoar
repetir	voltar
repeti��o	retumbo
replicar	retorq�ir
repoiso	sossego
reportar	reprimir
reportar-se	temperar-se
repousado	sopitado
repousar	vacar
repreender	trautear
repressor	repress�rio
repres�lia	vindita
repruir	velicar
reprurir-se	revoltar-se
reptador	reptante
repugnar	resistir
repulsar	reverberar
requestar	solicitar
reservat�rio	tanque
resguardar-se	tapar-se
residir	ser
resilir	zarpar
resist�ncia	subsist�ncia
resmung�o	rezing�o
resmuninhar	rezingar
resolubilidade	solubilidade
resoluto	valente
resolver	servir
respeito	v�nia
respeitoso	reverente
respingo	salpico
respiradoiro	suspiro
resplandecente	resplendoroso
resplendecer	ressaltar
responder	revidar
responsabilidade	segureza
ressabiado	ressentido
ressaibo	testemunho
ressaio	rossio
ressair	ressaltar
ressalto	salpicamento
ressarcir-se	restituir-se
ressa�do	ressaltado
ressecar	ressequir
ressentimento	tristeza
ressequido	torrado
ressicar	secar
ressoar	rimbombar
ressonadela	ronca
ressonar	retroar
ressudar	ressumar
ressurgir	tornar
ressurrecto	ressurreto
ressurtir	sair
restabelecimento	restauro
restante	sobejo
resto	sobra
restos	sarandalhos
restrugir	zonzear
resumidamente	sumamente
resvaladi�o	resvaladouro
retaguarda	traseira
retalha��o	sulcagem
retardador	retardante
retarda��o	retarde
retentivo	retentor
reten��o	tardada
reter-se	ter-se
retinir	zinir
retirada	sa�da
retirado	solit�rio
retirar-se	vazar
retoi�ar	travessear
retoque	revis�o
retorno	volta
retorq�ir	volver
retransir	transpassar
retrasar	retrogradar
retratar	transverberar-se
retrata��o	retrato
retroar	tempestuar
retrogradar	retrosseguir
retrosseguir	retrotrair
retr�til	retrativo
retumbar	toar
reunir	tomar
revel	teimoso
revelar	vender
revelar-se	testemunhar-se
revend�o	revendedor
rever	transverberar
rever-se	ver-se
reverdecer	verdecer
reverter	tornar
revestir	vestir
revir	vogar
revitalizar	roborar
revivificar	vivificar
revoltar-se	sublevar-se
revoltear	revolver
revolver	voltar
rezador	saludador
rezingar	testilhar
riamba	tabanagira
ricochete	zombaria
rigidez	severidade
rimar	versar
rimbomb�ncia	trov�o
rinha	rixa
ripa	sarrafo
ripada	zargunchada
rir	vasconcear
risada	riso
risca	tra�o
risota	zombaria
ritmo	som
roaz	roedor
robiss�o	sutambaque
roborizar	vitalizar
robustamente	vigorosamente
robustecer	tonificar
robustecimento	tonifica��o
robusteza	sa�de
roceiro	tabar�u
rocioso	r�rido
rodamoinho	tragadoiro
rodeio	rota��o
rodilhar	tapear
rodoi�a	rodou�a
rodomoinho	voragem
rodopiar	volutear
roer	sugilar
rogativa	s�plica
rojar	sacudir
rolar-se	sacolejar
rold�o	sarrabulhada
rolo	vagalh�o
romanticismo	romantismo
rombo	rompimento
rompedura	rotura
romper	rotura
rompimento	suspens�o
ronca	roncaria
roncar	rugir
rond�o	trapalhada
rosa	r�seo
roscado	rosqueado
rosear	tauxiar
rota	ten��o
rotina	vezo
roubar	sonegar
roubo	trapa�a
ro�ar	tangenciar
ro�o	soberba
rubescer	ruborizar
rubor	vermelh�o
rudez	xucrice
rugir	urrar
ruidar	rumorar
ruim	sinistro
rumor	runrum
rumorar	surdinar
rumorejar	surdinar
runrum	zunzum
rusgar	testilhar
r�bido	zangado
r�ncio	ran�o
r�cipe	ripada
r�gido	s�lido
sabido	tacanho
saboneira	saboneteiro
sabrecar	torrefazer
sabugo	tamboera
sabujo	samexuga
saca	sacola
sacada	sacadela
sacerdote	tonsurado
sacolejo	solavanco
sacramentar	ungir
sacudida	tremor
sadio	salutar
safadeza	safadice
safar	sobnegar
sagrado	venerando
saibrar	surribar
sair	suceder
salada	trapalhice
saliente	saltado
salpicado	sarapintado
saltar	transpor
saltarilhar	saltarinhar
saltarinhar	saltitar
saltear	unhar
salubre	saud�vel
salva	subterf�gio
salvar	saudar
sambador	sambeiro
samexuga	samexunga
samexunga	sendeiro
sanado	sarado
sandeu	tolaz
sandio	tolo
sangrador	sumidouro
sangue	vida
sanguinoso	subumano
sanja	valeta
santeiro	sant�rio
sapateado	sapateio
sapeca	tr�fego
saquear	tomar
saracoteamento	saracoteio
sarc�stico	trocista
sarja��o	sarjadura
sarj�o	sarjel
sarrapilheira	serrapilheira
sarro	sedimento
sar�al	silvado
sa�aricar	sururucar
sa�da	venda
sebe	tapume
secador	tedioso
seccionado	tronco
sect�rio	seguidor
sedar	sossegar
seguimento	subseq��ncia
seguir-se	superpor-se
segurado	seguro
segurar-se	suportar-se
seio	ventre
selar	terminar
selvagem	silv�cola
selvagino	silv�tico
sem-vergonhismo	vileza
semi-aberto	semicerrado
semib�rbaro	semi-selvagem
semicerrado	soaberto
semideiro	vereda
semimorto	semivivo
sem�foro	sinal
senadoria	senatoria
sendeiro	sevandija
senhorinha	senhorita
sensibilidade	subtileza
senso	sentido
sentir	travessar
sentir-se	tornar-se
septen�rio	seten�rio
septissecular	setissecular
septuagen�rio	setuagen�rio
sept�nio	set�nio
sequioso	s�frego
seq��ncia	transcorr�ncia
ser	suscitar
serelepe	turbulento
sereno	sossegado
serial	serir�rio
seroso	soroso
serpentante	serpenteante
serra��o	serragem
serr�til	serreado
servil	subserviente
servir-se	usar
servi�o	trabalho
sessar	sururucar
sestra	sinistra
sestro	sorte
setear	supliciar
seviciar	torturar
sev�cia	subumanidade
se��o	subdivis�o
sibilar	tinir
sibilo	silvo
silencioso	taciturno
silvar	sobiar
simiano	simiesco
simiesco	s�mio
simpatia	sufr�gio
simplesmente	unicamente
simplez	simpleza
sinal	tra�o
singelo	virginal
singrar	traspassar
sinistramente	tragicamente
sinopse	s�mula
sirtes	transe
soalhar	veicular
sobejos	varredura
sobnegar	tomar
sobrar	sobreabundar
sobre-restar	sobreviver
sobreabundar	superabundar
sobreagudo	superagudo
sobrechegar	suceder
sobredivino	supradivino
sobredourar	sublimar
sobreemin�ncia	superemin�nica
sobreexceder	transcender
sobreexcedido	ultrapassado
sobrelevar	suplantar
sobrelevar-se	sobrepujar
sobrepor	superpor
sobreposi��o	superposi��o
sobressaltar	transpor
sobrestima	superestima��o
sobrevir	suscitar-se
sobrevivente	supervivente
sobrevivo	sup�rstite
sobriedade	temperan�a
sobrolhos	superc�lio
socalcar	suplantar
soez	vil
sofisma	torcimento
sofreado	sufocado
sofrimento	supl�cio
solu��o	termina��o
sol�rcia	sutilidade
som	toada
sombreado	sombroso
sombrejar	turbar
somenos	vil�o
som�tico	sovina
sonetar	sonetear
son�fero	sopor�fero
sopitado	sopito
sopitar-se	soporizar-se
soporizar-se	subjugar-se
sordidez	torpitude
sord�cie	sordidez
sorna	zopo
soronga	tolo
sorrabar	titilar
sorrelfa	sovina
sorrir	tro�ar
sorver	varrer
sotaquear	tro�ar
sovinice	tacanhice
subdiretor	vice-diretor
subir	valorar
subjugar	trancafiar
sublimidade	superioridade
submeter	ter
submisso	s�dito
subordinar-se	torcer-se
subornado	vendido
subsecutivo	sucessivo
subsistir	vigorar
substanciar	tratar
subtilidade	talento
sucedimento	sucesso
suelto	v�ria
sufocar	tocar
sugerir	suscitar
sugestionador	sugestionante
sugestion�vel	sugest�vel
sujeira	tratada
sujeitar	vincular
sujei��o	timidez
sulcar	transpor
sumamente	sumariamente
sumarento	sumoso
superar	trasmontar
superestrutura	superstrutura
suplemento	suprimento
supletivo	suplet�rio
suportar	tomar
suprimir	viciar
surf	surfe
surgidoiro	surgidouro
suro	torado
surpreendido	surpreso
surpresar	vislumbrar
surrar	zurzir
surripiar	surrupiar
suspeitar	ver
suspei��o	suspeita
suspens�o	transporte
sussurrar	zinir
sustento	vivenda
suster	ter
s�ntese	uni�o
s�rdido	vil
tabefe	trolha
tabela	tabilha
tabernal	tavern�rio
tabern�culo	tenda
talante	vontade
tampa	tapador
tapadura	veda��o
tapeador	tunador
tapea��o	velhacaria
tape�ar	tapizar
tape�aria	tapete
tapigo	tapume
tardo	vagaroso
tarelo	vozeiro
tartamelar	tremelear
tascar	trincar
tasco	venda
teada	textura
tecido	teia
teima	teimosia
tela	trama
teleconduzido	teledirigido
televis�o	tev�
tema	terreno
temer�rio	venturoso
temido	valoroso
temperar	toar
tempestear	toar
tempestuar	torrar
tempestuoso	tormentoso
tenebrosidade	v�u
tenebroso	tremendo
tenso	teso
tentador	tentante
tentame	tentativa
tento	tino
ten��o	vista
teor	tom
tepor	tibiez
ter	torcer
terminologia	vocabul�rio
termo	t�mulo
terrorar	terrorizar
tesauro	thesaurus
tesoiro	tesouro
tessitura	tra�a
teste	verifica��o
testeira	vanguarda
textura	trama
tijucal	tujuco
tijuco	tujucal
tinir	tremer
tiradura	tiramento
tir�nico	tirano
titilar	xeretear
tituba��o	titubea��o
titubear	trepidar
toada	tono
toar	tocar
toireiro	tourista
toirista	toureador
tomadi�o	zangadi�o
tonante	tonitruante
tonitruante	ton�truo
tontear	transtornar
topada	trombada
torcedura	torcilh�o
torcilh�o	tor�o
tornar-se	transformar-se
tornejar-se	vergar-se
torpe	vil�o
torpeza	volutabro
torra��o	torragem
torvelino	turbilh�o
tosar	trosquiar
tosquiar	trosquiar
traduzir	transladar
tradu��o	translada��o
tragadouro	voragem
trajado	vestido
tramar	urdir
tramolhada	tujuco
tramontar-se	transmontar-se
trampolina	trampolinagem
trampolinagem	vigarice
tranca	tranqueta
trancar	vencer
transbordamento	vertedura
transbordante	trasbordante
transerrano	trasmontano
transferir	transpassar
transferir-se	transladar-se
transfer�ncia	translada��o
transfigurar	transubstanciar
transformar-se	transmudar-se
transgredido	violado
transgredir	travessar
transiente	transitivo
transir	trespassar
transluzir	transparecer
transmissivo	transmissor
transmitir	transmitir-se
transmontano	ultramontano
transubstanciar	transvestir
transverter	trasladar
tran�a	urdidura
trapaceador	trapacento
trapaceiro	tuno
trapalhada	trapalh�o
trapeziforme	trapezoidal
traquejar	trenar
traquina	ziguezigue
traquinagem	travessura
traquinice	travessura
traspasso	vagareza
tratamento	trato
tratantada	tratantice
tratante	velhaco
trato	uso
trava	trava��o
trave	travessa
travento	travoroso
trazer	vir
tra�a	tra�ado
treitento	velhaco
trejeitar	trejeitear
tremelear	tremer
tremelicar	tremer
tremular	trepidar
tresdobro	triplo
tresvariar	variar
trigueiro	triguenho
trilha	trilho
trilo	trino
trinado	trino
trinfar	trissar
tripas	v�sceras
triquestroques	trocado
trissar	zinzilular
triunfante	vencedor
troante	trovejante
troar	trovejar
troixa	z�ngano
tronchado	tronco
trope�ar	vacilar
trotar	vasconcear
tro�ador	zombeteiro
tro�ar	trotar
tr�ada	trio
tr�pego	zopeiro
tufado	tumefeito
tufar	turgescer
tujucal	tujuco
tumesc�ncia	turgidez
tumular	tumul�rio
tunador	vagabundo
turbar-se	velar-se
tutelar	tutorear
t�bua	tela
t�rax	torso
t�nica	tunicela
ufano	ufanoso
uivar	uivo
ultor	v�ndice
ultracorre��o	ultraurbanismo
uniformar-se	uniformizar-se
urdidura	urdimento
usan�a	v�cio
uso	utilidade
utens�lio	utilidade
utopista	vision�rio
vadiar	vagabundar
vadio	vagamundo
vagamundear	zaranzar
vaguejar	zaranzar
vaiv�m	volta
valedoiro	valedouro
valentia	veem�ncia
valent�o	van�loquo
vampirar	vampirizar
vaporizar-se	volatizar-se
vapor�vel	vaporiz�vel
vapular	zurzir
varia��o	variedade
varja	v�rzea
vasqueiro	z�imbo
vaziar	verter
vaz�o	vendagem
veda	veda��o
veda��o	vedo
veicular	zabumbar
veladura	velamento
velamento	vig�lia
veludoso	velut�neo
ven�fico	venen�fero
ver	viver
veracidade	veridicidade
verberador	verberante
verdejante	verdoso
verec�ndia	vergonha
versejar	versificar
vesgo	zanaga
vestido	vestu�rio
vexador	vexante
viandante	viandeiro
vicejante	vi�oso
vidrado	v�treo
viger	vigorar
vigiar	zelar
vigiar-se	vigilar-se
vinagr�o	zurrapa
vindicador	vindicante
vindicar	vingar
vinhago	vinhal
virar	voltar
virente	viridente
vista	visualidade
vis�vel	visivo
vivaz	vivedor
vivenciar	viver
volantim	volatim
volitar	voltear
vol�til	vol�vel
vozeada	vozeio
v�gado	vertigem
v�rio	vol�til
xenof�bico	xen�fobo
xerocopiado	xerografado
xingamento	xingo
xinga��o	xingo
zabumbar	zupar
zagalejo	zagalete
zanaga	zarolho
zanago	zer�
zangalho	zangaralh�o
zoina	zonzo
zopeiro	zopo
�-toa	imponderado
�cido	picante
�dipe	obesidade
�dvena	vindoiro
�gil	despachado
�lacre	influ�do
�lbido	alvacento
�lveo	leito
�pice	topo
�rabe	mouro
�rdego	arrojado
�rduo	penoso
�rido	fastiento
�rvore	esquema
�scua	fa�la
�spero	irregular
�vido	esganado
�mago	bojo
�ngulo	ponta
�nimo	arrojo
�nsia	engulho
�tica	valores
�mpar	�nico
�mpeto	viol�ncia
�mpio	sacr�lego
�mprobo	operoso
�m�	magnete
�ndice	tabela
�ntimo	pessoal
�bolo	pitan�a
�cio	ociosidade
�nus	pens�o
�mbrico	umbro
�til	vantajoso
